-----------------------------------------------------------------------------------------------------------------------------------------------------------------------------------------------------------
-----------------------------------------------------------------------------------------------------------------------------------------------------------------------------------------------------------
-----------------------------------------------------------------------------------------------------------------------------------------------------------------------------------------------------------
-----------------------------------------------------------------------------------------------------------------------------------------------------------------------------------------------------------
-----------------------------------------------------------------------------------------------------------------------------------------------------------------------------------------------------------
---------------------------------------------------BBB?????????????M---------------------------------------------------------------------------------------------------------------------------------------
--------------------------------------------------B---------------------------------mm---------------------------------------------------------------------------M-----------------------------------------
------------------------------------------------------------------------------------m-m--------------------------------------------------------------------------------------------------------------------
--------------------------------------------mm---m--------h---------------------mmmm---mmmmm-----------------------------mmmm------------------------------------------------------------------------------
--------------------------------mmm--------mm-mmmmm--?????????M????------------m####--#####-m--BBBB---------------------m###-m-----------------------------------mm---------------------------------------m
-------------------------------m[]-m------mm---[]--m------------------------K-m#####--######-m--------mmmm--------------m###--m---------mmmm--------Kmm---------m#-m-------------------------------------m[
--------------mm--mmm----------mpP--m------C---pP---m------------------------m######--#######-m--------[]-m-------K----m####---m-------m###-m-------m#----------m#--m---mm--mmm------mmm----mmm----------mp
--mmmmmmmmmmmmg-mmgg-mmmmmmmmmmmpP---mmmmmmc---pP----mmmmmmmmmmmmmmmmmmmmmmmm#######--########-mmmmmmmmpP--mmmmmmmmmmmmm####----mmmmmmmmB-#--mmmmmmmm#-mmmmmmmmmm#---mmmk-mmgg-mmmmmmgg-mmmmgg-mmmmmmmmmmmp
####################################################################################--#####################################################################################################################
