--------------------------------------------------------------------------------------------------------------------------------------###----#-##---?-----------------------###############################
----------------------------------------------------------------------------------------------------------------------------------------######-##----------------------------------------------------------
---------------------------------------------------------------------------------------------------------------------------------------------#-##----------------------------------------------------------
----------------------------------------------------------------------------------------------------------------------------------BBB----------######------------------------------------------------------
----------------------------------------------------------------------------------------------------------------------------------M--B-------------------------------------------------m-------------------
--------------------------------------------------------------------------------------------------------------------------------------B--------------------------#-------------------mm-m------------------
-------------------------------------------------------------------mmm----------------------mmm-----------------------------------mm------------------------------------------------m##--m-----------------
-----------------------------------------mm-----------------------m[]-m-------Kmmm---K-----m[]-m-------------------K-----mm------m#-B--------------------########-######-----------m###---m----------------
----------------------------------------m##m----------------------mpP--m-------mC-m--------mpP--m------------mm---------m#-m-----m#-mBk--------------------------#----------------m####----m---------------
---------------------------------------m##-#mmmmmmmmmmmmmmmmmmmmmmmpP---mmmmmmm-c--mmmmmmmmmc ---mmmmmmmmmmmmg-mmmmmmmmmm#--mmmmmm#---B---------K--------------------------------m#####-----m--------------
--------------------------------------m###-#########################################################################################-m-----------mm----mmm------mm--------------m######------m-------------
-----------mmm-----------------------m####------------------------------------------------------------------------------------------#---mmm--m-mm#-m---m#-m--m--m-m--m--m------m#######-------m---m-----m--
--mmmmmmmmmgg-mmmmmmmmmmmmmmmmmmmmmmm#####-------------------------------------------------------------------------------------------#mmm#-mmmmm##--mmm----mm-mm---mm-mm-mmmmmm########--------mmm-mmmmm-mm
###########################################-------------------------------------------------------------------------------------------##-#--#-#-##---##-----#--#----#--#--#-#-#########--------#-#---#-#--#
