--------------------------------------------------------------------------------------------------------------------------------------------------#--------################################################
--------------------------------------------------------------------------------------------------------------------------------------------------#--------################################################
--------------------------------------------------------------------------------------------------------------------------------------------------#--------################################################
------------------------------------------------------------------------------------------------------------------------m--------------------##---#--------################################################
-----------------------------------------------------------------h------------------------------------------------mmmmmm-m------------------#-----#--------################################################
--------------------------------------------------------------BBBBB??????----------------------------------------m######--m----------------------##-------#################################################
----------------------------------------------------------------------------------------------------------------m#######---m----------------------#########################################################
---------------------------------------------------------------------------------------------------------------m########----m-----------------------------#################################################
------------------------------------------------------mmm---------g-------------------------------------------m#########-----m---------mm---------------------#############################################
-----------------------------------------mmm---------mm[]mm----BBBBBBM???------------mmm---------------------m##########------m-------mm-mmm-------------mm----############################################
---------------------m------------------m[]-m-------mm-pP--m------------------------m[]-m----------m--------m###########-------m-----mm-----m-------m---mm-mm----------##########################----------
-------------------mm-mm----------------mpP--m------m--pP---m------------mm---------mpP--m-------mm-mm-----m############--------mm-m-m-------m--m--m-m--m----mmmmmmmmmm-------------------------mmmmmmmmmmm
--mmmmmmmmmmmmmmmmmgg-g-mmmmmmmmmmmmmmmmmpP---mmmmmm---pP----mmmmmmmmmmmmg-mmmmmmmmmmpP---mmmmmmmgg-g-mmmmm#############--------#-m-m---------mmmmmk--mm-----##########mmmmmmmmmmmmmmmmmmmmmmmmm###########
########################################################################################################################################-------#--##---#----###############################################
