-------------------------------------------------------------------------------------------?####------------------------------------------------------#####################################################
------------------------------------------------------------------------------------------m#####------------------####-------------------------------------------------------------------------------------
------------------------------------mmm---------------------------------m----------------m######-------------##----------#######---------------------------------------------------------------------------
-----------------------------------mm[]mm--?------???????????????M-------mm-------------m#######-----------------------------------------------------------------------------------------------------------
----------------------------------mm-pP--m------------------------------m#-m-----------m########----------------------------------------Y----------------------------mm-------------------------m----------
----------------------------------m--pP---m-mm--------------mmmm--------m#--m-mmm----Km#########----------------------------------#-----y---------------------------mm-m---------------------mmm-m---------
-----------------------mmmmmmmmmmm---pP----mg-mmmmmmmmmmmmmmggg-mmmmmmmm-#---mgg-mmmmm#####################------------------------#####>--------------------------mm---m-------------------m###--m--------
----------------------m#####################################################################-----------------------------------------------------------------------m-----m-----------------m####---m-------
---------------------m##------------------------------------------------------------------------------------------------------------------------------------------m-------m---------------m#####----m------
--------------------m###------------------------------------------------------------------------------mm-------------------------mm------------mm----------------m#--------m-------------m######-----m-----
-------------------m####-------------------------------------------------------------------------m---mm-m------------------------m-m---mm-----mm-mmm------------m##---------m-----------m#######------m----
------------------m#####---------------------------------------------------------------------mmmm-m--m---m--m----m------m----m--m---m--m-m----m-----m----------m###----------m---------m########-------m---
--mmmmmmmmmmmmmmmm######--------------------------------------------------------------------m####--mm-----mm-mmmm-mmmmmm-mmmm-mm#----mm---mmmm-------mmmmmmmmmm####-----------mmmmmmmmm#########--------mmm
########################--------------------------------------------------------------------#####---#------#--#-#--#-#-#--#-#--#------#----#-#--------#-#-#-#-#####-----------#-#-#-############--------#-#
