-----------------------------------------------------------------------------------------------------------------------------------------------------------------------------------------------------------
-----------------------------------------------------------------------------------------------------------------------------------------------------------------------------------------------------------
-----------------------------------------------------------------------------------------------------------------------------------------------------------------------------------------------------------
-----------------------------------------------------------------------------------------------------------------------------------------------------------------------------------------------------------
-----------------------------------------------------------------------------------------------------------------------------------------------------------------------------------------------------------
-----------------------------------------------------------------------------------------------------------------------------------------------------------------------------------------------------------
-----------------------------------------------------------------------------------------------------------------------------------------------------------------------------------------------------------
---------------------------------------------------------------------B-------------------------------------------------------------------------------------------------------------------------------------
--------------------------------m---------------------------------------------------------------------mmm-------------------------------------------mmm----------------------------------------------------
-------------------------------mmm-------mmm-------------------------mm-------mm-----------------------m#m---------------mmm-----------mmm---------mm[]m---------------------------------------------------
-----------------------mmm----mm--m-----m[]-m--------------mmm-------m-------m#-m--------------------mm-#-m----mmm-------mK-m----KK--Km[]-m-------mm-pP-m------??----------------mmm-----------------mm----
-----------------------mC-m----C---m----mpP--m--------mmm---C-m-----m#-m-----m#--m----mmm-------------#-#--m---h#-m------m---m--------mpP--m------m--pP--m-------mmm--------------#-mm-------mmm----m#-m---
--mmmmmmmmmmmmmmmmmmmmm-c--mmmmc----mmmmmc ---mmmmmmmmgg-mmmc--mmmmmm#--mmmmmm#---mmmmgg-mmmmmmmmmmmmmC-#---mmmm#--mmmmmm-----mmmmmmmmmpP---mmmmmm---pP---mmmmmmmgg-mmmmmmmmmmmmmm#-k-mmmmmmmgg-mmmmm#--mmm
###########################################################################################################################################################################################################
