-------------------------------------------------------------------------##############################################################################################################################----
-------------------------------------------------------------------------------------------------------------------------------------------------------------------------------------------------------#---
-----------------------------------------------------------------------------------------------------------------------------------------------------------------------------------------------------------
-----------------------------------------------------------------------------------------------------------------------------------------------------------------------------------------------------------
----------------------------------------------------h------------------------------------------------------------------------------------------------------------------------------------------------------
----------------------------------------------BBBBBBM?M----------------------------------------------------------------------------------------------------------------------------------------------------
-----------------------------------------------------------------------------------------------------------------------------------------------------------------------------------------------------------
----------------------------------------------------------------------------------------------mmm-------------------------------------------------------------------------mm-------------------------------
--------------------------------------mmm----------------------------------------------------m#B-m-----------------------------------------------------------------------m#-m------------------------------
---------------?----------mm---------mm[]mm--BBBBBBBBB-?-----------B*---mmm-----------------m##---m---------------------------mmmmmmm-----------------------------------m##--m-------------------mmmmmmm---
------------------mmm----mC-m--------m-pP--m------------------mmm------m[]-m---------------m###----m-------------------------m######-m---------------------------------m###---m-----------------m#######m--
------------------mC-m---mc--m------mC-pP---m-----------------mC-m-----mpP--m--------mmm--m####-----m----mm-----------------m#######--m----------------------------m--m####----m------------m--m#######-#mm
--mmmmmmmmmmmmmmmm-c--mmmmC---mmmmmmmc-pP----mmmmmmmmmmmmmmmmm-c--mmmmmmpP---mmmmmmmm##-mm#####------mmmm#-mmmmmmmmmmmmmmmmm########---mmmmmmmmmmmmmmmmmmmmmmmmmmmm-mm#####-----mmmmmmmmmmmm-mm########--#-
###########################################################################---#-#-#-#-#--######-------#-#--#-#-#-#-#-#-#-###########----#-#-#-#-#-#-#-#-#-#-#-#-#-#--######------#-#-#-#-#-#--#########----
