----------------------------------------------------------##########################-----------------------------------------------------------------------------------------------------------------------
------------------------------------------------------------------------------------#----------------------------------------------------------------------------------------------------------------------
-----------------------------------------------------------------------------------------------------------------------------------------------------------------------------------------------------------
-------------------------------------------------------------------------------------#---------------------------------------------------------------------------------------------------------------------
--------------------------------------------------------------------------------------------------------------------mm-------------------------------------------------------------------------------------
-------------------------------------------------------------------------------------------------------------------m#-m------------------------------------------------------------------------------------
---------------------------------------------B------------*-------------------------------------------------------m##--m-------mm--------------------------------------------------------------------------
----------------------------------------------------------------------------------------------?MBBBBBB#----------m###---m-----mm-mmm-----------------------------------------------------------------------
---------------------------------------------------------m------------------------------------------------------m####----m---mm-----m----------------------------------------------------------m-----------
---------------------------------------------mm----------mmm---------------------mmmmm-------------------------m#####-----m--m-------mm----mm------------mm-------mm-------mm-------mm-------mm-mm--------m
--------------------------------------------m#-m-------mm-?-m-------------------m#####mmmmmmmmmmmmmmmmmmmmmmmmm######------mm--------#-mmmm#-mmmmmmmmmmmmg-mmmmmmmg-mmmmmmmk-mmmmmmmk-mmmmmmmkk-k-mmmmmmmmk
-----------------------mm-----------mmm-----m#--m------m#----m----------mmmmm--m####-###########################################-----#-####################################################################
--mmmmmmmmmmmmmmmmmmmmmg-mmmmmmmmmmmgg-mmmmmm#---mmmmmm-#--#--mmmmmmmmmm####-mm#####-----------------------------------------------------------------------------------------------------------------------
############################################################---#-#-#-#-#-#-#--######-----------------------------------------------------------------------------------------------------------------------
