-----------------------------###-#######################################################-------------------------------------------------------------------------------------------------------------------
-----------------------------------------------------------------------------------------------------------------------------------------------------------------------------------------------------------
---------------------------------------------------------------------------------------------------------------------------------------------------------------------mm------------------------------------
-------------------------------------------------------------------------------------------------------mmm----------------------------------------------------------m#-m-----------------------------------
------------------------------------------------------------------------------------------------------mm[]mm-------------------------------------------------------m##--mmmm-------------------------------
-----------------------------------------------------------------------------------------------------mm-pP--m-----??????------------------????M??-----------------m###--B?M-m------------------------------
----------------------------------------------------------------------------------------------------mm--pP---m---------------------------------------------------m####------#m---------------------------mm
--------------------------------------------------------------------------------------mmmmmmmmmmmmmmm---pP----mm----mmmmm-----mmm------mm---mmm----------------mm#####------#-m------mm------------mm---m#-
------------------------------------------------mmmmmm-------------------------------m####################----k-mmmmgg-k-mmmmmgg-mmmmmmk-mmmgg-mmmmmmmmmmmmmmmmk######------#--mmmmmmk-mmmmmmmmmmmmk-mmmm#-
---------------------------mmm-----------------m####B-m-----------------------------m##---------------------###############################################################################################
-------------------Kmmm---mm#-m---------mmmmmmm#####---m---------------------------m###--------------------------------------------------------------------------------------------------------------------
--------------------mC-m---##--m-----mmm############----m----------m--------------m####--------------------------------------------------------------------------------------------------------------------
--mmmmmmmmmmmmmmmmmm-c--mmm##---mmmmm###############-----mmmmmmmmmm-mmmmmmmmmmmmmm#####--------------------------------------------------------------------------------------------------------------------
###############################-#-#-################------#-#-#-#-#--#-#-#-#-#-#-######--------------------------------------------------------------------------------------------------------------------
