-----------------------------------------------------------------------------------------------------------------------------------------------------------------------------------------------------------
-----------------------------------------------------------------------------------------------------------------------------------------------------------------------------------------------------------
-----------------------------------------------------------------------------------------------------------------------------------------------------------------------------------------------------------
-----------------------------------------------------------------------------------------------------------------------------------------------------------------------------------------------------------
-----------------------------------------------------------------------------------------------------------------------------------------------------------------------------------------------------------
-----------------------------------------------------------------------------------------------------------------------------------------------------------------------------------------------------------
-----------------------------------------------------------------------------------------------------------------------------------------------------------------------------------------------------------
--------------------------------------------------------------------------------------------------------M-------------------------------------------------------------------------------------mmmmmmmmmmmmm
---------------------------------------------------------------------------------------------------------------------------------------------------------------------------------------------m#############
-------------------------------------------mm-------------------------------------------------------------BBBB-----------------mm------------------------------------mmm-----------------m--m##############
-----------------------------m------------m#-m------------------------------------mm---m----K--mmm-----mm---------------------m#-m-------------------------m--------m[]-m---------------mmmm###############
--------------------mm-----mm-mm----------m#--m------mm-m---------mmm------------m#-m-mmm-------#-m----K#m----------Kmm-------m#--m--mmmm-----mm--mm-----mm-mm------mpP--m------mmm------##################
--mmmmmmmmmmmmmmmmmmg-mmmmmgg-g-mmmmmmmmmmm#---mmmmmm#-m-mmmmmmmmmm#-mmmmmmmmmmmmm#--mm--mmmmmmm#--mmmmm#-mmmmmmmmmmmk-mmmmmmmm#---mmkgg-mmmmmk-mmg-mmmmmgg-g-mmmmmmmpP---mmmmmmgg-mmmmmm#-################
###########################################################################################################################################################################################----------------
