-----------------------------------------------------------------------------------------------------------------------------------------------------------------------------------------------------------
-----------------------------------------------------------------------------------------------------------------------------------------------------------------------------------------------------------
-----------------------------------------------------------------------------------------------------------------------------------------------------------------------------------------------------------
---------------------------------------------------------------------------------------------------------------------------------------------------------------m-------------------------------------------
-------------------------------------------------------------------------------------------------------------------------------------------------------------mm-m------------------------------------------
------------------------------------------------------------------------------------------------------------------------------------------------------------m##?-m-----------------------------------------
------------------------------------------------*B---------------------------------*B----------------------------------------M-----------------------------m###---m----------------------------------------
----------------------------------------------------------------------------------------------------------------------------------------------------------m####----m---------------------------------------
-------------------------------------K-------------------------------------------------------------------------------------------------------------------m#####-----m-----------------------?--------------
------------------------------------------------mm---------------------------------mm----------------------------------------mm-------------------------m######------m-------------------------------------
-------------------m----------------mmm--------m#-m----------------------mmm-----Km#-m-------------------------------mm-----m#-m-----------------------m#######-------mm-m---------------mm----------------
------------------m-mmm------------m##-m-------m#--m--mmm---mm----------m##-m-----m#--m--------mmm-------------mm---m#-m----m#--m---mmm-----mmm-------m########-------#-m-mmmmmmmmmmmmmmmg-mmmmmmmmmmmmmmmm
--mmmmmmmmmmmmmmmmg-gg-mmmmmmmmmmmm#-#--mmmmmmmm#---mmgg-mmmk-mmmmmmmmmm#-#--mmmmmm#---mmmmmmmmgg-mmmmmmmmmmmmmk-mmmm#--mmmmm#---mmmgg-mmmmmgg-mmmmmmm#########-###########################################
################################################################################################################################################################-------------------------------------------
