-------------------------------------------------------------------------------------------------------------------------------------------------------------------------------pP----#-#------#-##########-
-----------------------------------------------------------------------------------------------------------------------------------------------------------------------------##############################
-----------------------------------------------------------------------------------------------------------------------------------------------------------------------------------------------------------
------------------------------------------------------------------------------------------------------------------------------------------------m----------------------------------------------------------
-----------------------------------------------------------------------------------------------------------------------------------------------m-m---------------------------------------------------------
-------------------------------------------------------------------------------------------------BBBB----------------------------------------mmg--m--------------------------------------------------------
---------------------------------------------------------------------B-------------------------BB----------------------------M--------------mg##---m---------------------------------------------------mmmm
--------------------------------------------------------------------------------------------------------------------------------------------m###----m-------------------------------------------------m####
----------------------------------------------------------------------------------------------m--------------------------------------------m####-----m-----------------mmm---------------------------m#####
------------??M???----------------------------------mmm--------------mm-----------------------mm----O*--mmm------------------mm-----------m#####------m---------------mm[]mm------------------------m######
-----------------------------------------mmmm------m[]-m------mmm---m#-m--------------------mm-?m------mm#-m--------mm------m#-m---------m######-------m-------------mm-pP--m----------------------m#######
-----------------------------------------m[]-m-----mpP--m------C-m--m#--m-----mmm-----------m#---m-----m-#--m-mmm--m#-mm----m#--m-------m#######--------mm-m---------m--pP---m--------------------m########
--mmmmmmmmmmmmmmmmmmmmmmmmmmmmmmmmmmmmmmm-pP--mmmmmmpP---mmmmmmc--mmm#---mmmmmgg-mmmmmmmmmmm-#----mmmmm--#---mgg-mmm#-#-mmmmm#---mmmmmmm########--------#-m-mmmmmmmmm---pP----mmmmmmmmmmmmmmmmmmmm#########
#######################################################################################################--#################################################################-----#[]-#-####-#-#-##-##########
