-----------------------------------------------------------------------------------------------------------------------------------------------------------------------------------------------------------
-----------------------------------------------------------------------------------------------------------------------------------------------------------------------------------------------------------
-----------------------------------------------------------------------------------------------------------------------------------------------------------------------------------------------------------
-----------------------------------------------------------------------------------------------------------------------------------------------------------------------------------------------------------
-----------------------------------------------------------------------------------------------------------------------------------------------------------------------------------------------------------
-----------------------------------------------------------------------------------------------------------------------------------------------------------------------------------------------------------
-------------------------------------------------------------B-------------------------------------------------------------------------------------------------------------------------------------M-------
-----------------------------------------------------------------------------------------------------------------------------------------------------------------------------------------------------------
--------------------------------------------------------------------------------------------------------------------------------------------------m--------------------------------------------------------
-----------BBB#----------------------------------------------mm-----------------mmm----------------------------------------------------------------------------------------------------------------mm------
---------------------------------------m--------------mm----m#-m---------------m[]-m---------------mmmm--------------------------mmm-------------m-m-------------------------------------------K--m#-m-----
--------------------------------------m-mmm----------m#-m---m#--m-------mmm----mpP--m-----mmm------m[]-m----------mmm-------------#-m-------------m-mm-----------------------mm-------------------m#--m----
--mmmmmmmmmmmmmmmmmmmmmmmmmmmmmmmmmmmmg-gg-mmmmmmmmmmm#--mmmm#---mmmmmmmgg-mmmmmpP---mmmmmgg-mmmmmm-pP--mmmmmmmmmmgg-mmmmmmmmmmmmm#--mmmmmmmmmmmmm--#-mmmmmmmmmmmmmmmmmmmmmmmk-mmmmmmmmmmmmmmmmmmmm#---mmmm
###########################################################################################################################################################################################################
