---------------------------------------------------#--###########--------#------#--------------------------------------------------------------------------------------------------------------------------
--------------------------------------------------#######################################------------------------------------------------------------------------------------------------------------------
-----------------------------------------------------------------------------------------------------------------------------------------------------------------------------------------------------------
-----------------------------------------------------------------------------------------------------------------------------------------------------------------------------------------------------------
-----------------------------------------------------------------------------------------------------------------------------------------------------------------------------------------------------------
----------------------------------------------B-BBB---------------m-------------------------------------------------------------------------------------------------------------------?--------------------
----------------------------------------------------------------mm-m---------------------------------------------------------------------------------------------------------------------------------------
---------------------------------------------------------------m##--m-------------------------------------------------------------------mm-----------------------------------------------------------------
---------------------------------mmm----------mmmm------------m###---m-----------------------------------------------------------------mm-mmmmm------------------mm----------------------------------------
--------------------------------mm[]m--------mm[]-m----------m####----m---------------------------------------------------------------mm----[]-m--??M???????-----m-mmm----???????????-?--------------------
--------------------m-----------m-pP-m-----?-m-pP--m--------m#####-----m--------mm----------------mmm-----------------------m---------m-----pP--m-----K-------mmm--[]-m---------K--------------------------
-------------------m-mm--------m--pP--m-----m--pP---m------m######------m----?-mm#mmm------mm-m---m#-m----------mmm-------mm-mm-----mm------pP---m------------m[]--pP--m-----------------------------------
--mmmmmmmmmmmmmmmmmg-k-mmmmmmmmm--pP---mmmmmg--pP----mmmmmm#######-------mmmmmmm-#---mmmmmm#-m-mmm-#--mmmmmmmmmmkk-mmmmmmmkk-k-mmmmmkk-k----pP----mmmmmmmmmmmm-pP--pP---mmmmmmmmmmmmmmmmmmmmmmmmmmmmmmmmmmm
#################################################--##-############--------#-#-#--#----#-#-#################################################################################################################
