----------------------------------------------------#######################################################################################################################################################
--------------------------------------------------------------------------------------------------------------------------------------------------------------##m##########################################
------------------------------------------------------------------------------------------------------------------------------------------------------------------#########################################
-------------------------------------------------------------------------------------------------------------------------------------------------------------mm--m#########################################
------------------------------------------------------------------------------------------------------------------------------------------------------------mm-m-------------------########################
-------------------------------------------------------------------------------------------mmmm-------------------------------------------------------------m-----mmmmmmmmmmmmmmmmm-#######################
------------------------------------------------------------------------------------------m###-m-----------------------------------------------------------m-----##################m--#####################
----------------------------------------------------mmm----------------------------------m####--m-------------------------mm------------------------------m#-----###################mm-####################
-------------------------------------------------mmm##-m--------------------------------m#####---m------------------------m-m------------mm--------------m#-----######################m--------------------
------------------------------------------------m#####---------------------------------m######?---m--------------------mmm---m----------m#-m------------m##-----#######################mmmmmmmmmmmmmmmmmmmm
-----------------------m-----------------------mm#####+-m-----------------------------m#######-----m------------------m###----m--------m##--mo---------m###-----###########################################
----------------------m-mmm-------------mm------######-------------------------------m########------m---m------------m####-----mmm----m###---m----mmmmm####-----###########################################
--mmmmmmmmmmmmmmmmmmmmg-gg-mmmmmmmmmmmmmk-mmmmmm###-##---mmmmmmmmmmmmmmmmmmmmmmmmmmmm#########-------mmm-mmmmmmmmmmmm#####-----[]-mmmm####----mmmm#########-----###########################################
######################################################----#-#-#-#-#-#-#-#-#-#-#-#-#-##########-------#-#--#-#-#-#-#-######-----pP--#-#####-----#-##########----############################################
