-----------------------------------------------------------------------------------------------------------------------------------------------------------------------------------------------------------
-----------------------------------------------------------------------------------------------------------------------------------------------------------------------------------------------------------
----------------------------------------------------???M-------------BB------------------------------------------------------------------------------------------------------------------------------------
--------------------------#---------------------V------------------BBB-B-----------------------------------------------------------------------------------------------------------------------------------
--------------------------#------------------------------------mm-------BB-BBB-----------------------------------------------------------------------------------------------------------------------------
--------------------------#----------------mmm--pP------------mm-m--------BB----------------------------M----------------------------------------M--------------------------------M------------------------
--------------------------#---------------mm[]mm-?????MBM-----m---m--mmm---------------------------------------------------------------------------------------------------------------------------------mm
------------------------mm---------------mm-pP--m--?-------mmm-----mmmmmm------------------------------------------------------------------------------------------m------------------------------------m##
-----------------------m##m--------------m--pP---m---------m[]-----[]----m------------------------------mm---------------------------------------mm---------------mmm-------------mm-------------------m###
--------????----------m####mmmmmmmmmmmmmm---pP----mmmmmmmmm-pP-----pP-----m------Kmm------m------------m#-m---------------------------m---------m#-m--------------m--m-----------m#-m-----------------m####
----------------K----m###-#############################################----m-----m#-m---mm-mm----------m#--m-mmm--------mmm------mm-mm-mmm------m#--m----mmm----mm-k--m----------m#--m----mm-mm----mmm#####
--------------------m####---------------------------------------------------mmmmmm#--mmmgg-k-mmmmmmmmmmm#---mgk-mmmmmmmmgg-mmmmmmk-mgg-gk-mmmmmmm#---mmmmgg-mmmmgg-#---mmmmmmmmmmm#---mmmmk-mg-mmmm########
--mmmmmmmmmmmmmmmmmm#####-------------------------------------------------#################################################################################################################################
##########################---------------------------------------------------------------------------------------------------------------------------------------------------------------------------------
