-------------------------------------------------------------##----##--#################################################################################-#----------##--#########--------------------------
--------------------------------------------------------------##------------------------------------------------------------------------------------------##-----------------------------------------------
-----------------------------------------------------------------------------------------------------------------------------------------------------------------------------------------------------------
-----------------------------------------------------------------------------------------------------------------------------------------------------------------------------------------------------------
-------------------------------------------------------------------------------------------------------------------------------------------------------m?--------------------------------------------------
-----------------------------------------------------------BBB------------------------------------mm-------------------------------------------------mm----------------------------------------------------
-------------------------------------B----------------------B-B----------------------------------m#-m-----------------------------------------------m##?---------------------------------------------------
---------------------------------------------------------------BB-------------------------------m##--m---------------------------------------------m###----------------------------------------------------
-------------------------------------------------------mm---------------mm---------------------m###---m-------------------------------------------m####----------------------------mm----------------------
------------BM??---------------------mm---------------mm-mmmmm---------mm---------------------m####----m-----------------------------------------m#####-----------mm--------------mm-mmm-------------------
-----------------------------mmm----m#-m-------------mm----[]-m-------mm-#mm-----------------m#####-----m---------------------------------------m######?---------mm-mmm----------mm-----m------------------
-------------------mmm-------m#-m---m#--m-----mmm----m-----pP--m------m--##-m------------m--m######------m-----------------m-------------------m#######----m-----m-----m----m----m-------m----------mm-----
--mmmmmmmmmmmmmmmmmgg-mmmmmmm-#--mmmm#---mmmmmgg-mmmm------pP---mmmmmm---##--mmmmmmmmmmmm-mm#######-------mmmmmmmmmmmmmmmmm-mmmmmmmmmmmmmmmmmmm########-----mmmmm-------mmmm-mmmm---------mmmmmmmmmmk-mmmmm
##############################################################---##-##---##---#-#-#-#-#-#--########-------#-#-#-#-#-#-#-#-#--k-##-#-#-#-#-#-#-#########--#--#-#-#--------#-#--#-#---------#################
