----------------------------------#------------------------------------------------------------------------------------------------------------------------------------------------------------------------
-----------------------------------------------------------------------------------------------------------------------------------------------------------------------------------------------------------
-----------------------------------------------------------------------------------------------------------------------------------------------------------------------------------------------------------
---------------------------------------------------------------------------------------------------------------------------B---B---------------------------------------------------------------------------
---------------------------------------------------------------M----------------------------------------------------------------B--------------------------------------------------------------------------
---------------------------------------------------------------------------------------------------------------------------------B-------------------------------------------------------------------------
--------------------------------m--------------------------------------------------------mm--------------------mmmm----------mm----------------------------------------------------------------mm----------
-------------------------------m-mm----------????????----------mm-------------K----------[]m------------------mm[]-m--------mm-m--------------------------------------------------------------mm-mmm-------
-------------------------------mg##mm-------------------------m#-m-----------mmmm-------mpP-m-----------------m-pP--m------mm---m--------------------------mmm--------------------------------m----Vmm-----
---------------------?---------m####-m------------------------m#--m--mm------m[]-m------mpP--m------mmm-----mm--pP---m-----m-----m------------------------mmm-mmmmm-------------------------mm-----[]-m--??
------------------------------m###--#-mmmmmmmmmmmmmmmmmmmmmmmmm#---mmg-mmmmmm-pP--mmmmmmmpP---mmmmmmgg-mmmmmgg--pP----mmmmm-------m-------------K---------m-----[]-m-------mmmm------------m[]-----pP--m---
-----------------------------m####---######################################################################################--------m--------------mmm---mm------pP--m------m[]-m-----------mpP-----pP---m--
--mmmmmmmmmmmmmmmmmmmmmmmmmmm#####--------------------------------------------------------------------------------------------------mmmmmmmmmmmmmmgg-mmmgg-g----pP---mmmmmm-pP--mmmmmmmmmmmmpP-----pP----mm
###################################-----------------------------------------------------------------------------------------------#########################################################################
