-----------------------------------------------------------------------------------------------------------------------------------------------------------------------------------------------------------
-----------------------------------------------------------------------------------------------------------------------------------------------------------------------------------------------------------
---------------------------------------------------------------------------------------------------------------------------------------------------------------------------------m-------------------------
----------------------------------------------------------------------------------------------------------------------------------------------------------------------------------m------------------------
-------------------------------------------------------------------------------------------------------------------------------------------------------------------------------mm--m-----------------------
------------------------------------------------------------------------------------------------------------------------------------------------------------------------------m##---m----------------------
----------------------------------------------------M------------------------------------------------------------------------------------------------------B---------------m-m###----m---------------------
---------------------------------------------------------------------------------------M----------------------------------------------------------------------------------mgm####-----m--------------------
--------------------------------------------------------------------------------------------------------------------------------------------------------------------------mg#####+-----m-------------------
------------??????----------------------------------mm-----------------------------------------------------------------------------------------------------mm-------------m######-------m------------------
---------------------------------------------mm----m#-m----mmm----------------mmm-----Kmm----------------m---------mm-----------mmm---------mm------------m#-m-----------m#######--------m---------mmmm---m
----------------------------mm---------mm---m#-m---m#--m---m#-m-----mmm--------#-m----m#-m-----mm------mm-mm------m#-m-----------#-m-------m#-m--K--------m#--m---------m########---------mm-m-----m[]-m--m
--mmmmmmmmmmmmmmmmmmmmmmmmmmg-mmmmmmmmmk-mmmm#--mmmm#---mmm-#--mmmmmgg-mmmmmmmm#--mmmmm#--mmmmmk-mmmmmmgg-g-mmmmmmm#--mmmmmmmmmmm#--mmmmmmmm#--mmmmmmmmmmmm#---mmmmmmmmm#########---------#-m-mmmmm-pP--mm-
###########################################################################################################################################################################################################
