-------------------------------------#-?#----#--#---#-------########--------#--------------------------#---------------------------------------------------------------------------------------------------
-----------------------------------########--#########-----#####################--------------#############------------------------------------------------------------------------------------------------
-----------------------------------------------------------------------------------------------------------------------------------------------------------------------------------------------------------
-----------------------------------------------------------------------------------------------------------------------------------------------------------------------------------------------------------
---------------------------------------------------------------------------------------Y-------------------------------------------------------------------------------------------------------------------
---------------------------------------------------------------------m-----------------y-----------------------------------------------------------------------------mm-----------------------?M??----BBB??
-------------------------------------------------------------------mm-m-----------##--##----------------------------------------------------------------------mm----mm-m-----------------------------------
--------------------------M----------------------------*B---------m##--m-----------###-----------------------------------------------------------------------mm-mm--m---m----------------------------------
-------------------------------------------------------*---------m###---m------------------------------------------------------------------------------------m----mm-----mmm-------------------------------
----------------------------BBBBBB------------------------------m####----m-------mm-------------------------mm----------------------------------K----------mm-----[]-----[]-m---???????M???????-B#------???
------------------mmm----mmm--------------------------mmm------m#####-----m-----mm-m--mm-------------------mm-mmm---mmm----------------------------mm-----m[]-----pP-----pP--m-----------------------------
------------------m#-m---K#-m----mmm--------mmm-------m?#mm---m######------m----m-----m-m----m-------------m-----m--mC-m--------------------------mC-m-K--mpP-----pP-----pP---m------------------------mmmm
--mmmmmmmmmmmmmmmm-#--mmmm#--mmmmm#-mmmmmmmmmm#mmmmmmm---#-mmm#######-------mmmm----mm---mmmm-mmmmmmmmmmmmm-------mm-c--mmmmmmmmmmmmmmmmmmmmmmmmmmmc--mmmmmpP-----pP-----pP----mmmmmmmmmmmmmmmmmmmmmmmmggg-
###################################--##-##-#--#-##-###------#########--------#-#-----#----#-#--#-#-#-#-##-#--------########################################################################################
