---------------------------------------------------##--------------------------------------------------------------------------######-----------------------------------###--------------------------------
----------------------------------------------------------------------------------------------------------------------################-----------------------------------#############---------------------
--------------------------------------------------------------------------------------------------------------------------------------#---------------------------------------------------------##---------
--------------------------------------------------------------------------------#####----###---##--------------------------------------####----------------------------------------------------------------
--------------------------------------------------------------------------mmm-##---------------##----------------------------------------------------------------------------------------------------------
-------------------------------------------------------------------------mB?-m-----------------##----------------------------------------------------------------------------------------------------------
---------------------------------------------------oo-------------------m#----m---------------###---------------------------------------------------------------------------m------------------------------
-----------------------------------------------------------------------m##-----m---------------#####--#---#------------------------------------------------------------mmmmm-m-----------------------------
------------------------------------------------mmm-------------------m###B-----m----------------------###------------------------------------------------------------m#####--m----------------------------
---------?M?-----------------------------------m##-m-----------------m####-------m-----------------------------------mm--------------mmm-----------------------------m##-###---m-------mm------------------
----------------------------------------------m###--m---------------m#####--------m----------mm-----mm--------------mm-m------------m##-m---mmm-----------mmm-m-----m###-###----m-----mm-m---mm------------
------------------------------mm-------------m####---m-------------m######---------m--mmm----m-m----m-m--m--m-------mY--m----------m##---m--m?-m----------m#-m-m---m####-###-----m----m---m--m-m-----------
--mmmmmmmmmmmmmmmmmmmmmmmmmmmmk-mmmmmmmmmmmmm#####----mmmmmmmmmmmmm#######----------mm##-mmmm---mmmm---mm-mm-mmmmmmm-y---mmmmmmmmmm###----mm----mmmmmmmmmm-#-k--mmm#####-###------mmmm-----mm---mmmmmmmmmmm
##################################################-----###################-----------#------#----#-#----#--#--########----#-#-########-----#?----###########################-------#-#------#----#-########
