-------------------------------------------------------------------------------------------------------------------------------------------################################################################
-----------------------------------------------------------------------------------------------------------------------------------------------------------------------------------------------------------
-----------------------------------------------------------------------------------------------------------------------------------------------------------------------------------------------------------
-----------------------------------------------------------------------------------------------------------------------------------------------------------------------------------------------------------
-------------------------------------------------------------------------------------------------mmm------------------------------------------------------------------------------m------------------------
-----------------------------------------------------------------BBBBBBBBB----------------------m##-m--------------------------------------------------------------------------mmm-m-----------------------
-----------------------------------------------------------------------------------------------m###--m------------------------------------------------------------------------m###--m----------------------
----------------------------------------------------------------------------------------------m####?--m-----------------------------------M----------------------------------m####---m---------------------
---------------------------------------------------------------mm----------------------------m#####----m-----------------------------------m--------m-----------------------m#####----m--------------------
--------------------------------------------------------------mm#m-BBBBBBBBB---m------------m######-----m----------------------------------mm------m#m---------------------m######-----m-------------------
--------------------------------m-----------------------------m-#-m-----------m#m----------m#######------m--------------------------------m--mm---m##---------------------m#######------m------------------
-------------------------------m-mmm------------------mm-----m--#--m-------K--m#-m--------m########-------mm-m---------mm----------------m#--#---m###-m------------------m########-------m---m----m----m---
--mmmmmmmmmmmmmmmmmmmmmmmmmmmmmg-gg-mmmmmmmmmmmmmmmmmmk-mmmmmg-g#---mmmmmmmmmmm#--mmmmmmmm#########-------#-m-mmmmmmmmmg-mmmmmmmmmmmmmmmmm#--#-mm####--mmmmmmmmmmmmmmmmmm#########--------mmm-mmmm-mmmm-mmm
############################################################################################################################################-#--#####---#-#-#-#-#-#-#-#-##########--------#-#--#-#--#-#--#-
