-------------------------------------------------------------------------#------------------------########-------#---------##---pP--------#######-------#---####------------#----#--#----------------------
-------------------------------------------------------------------------#-------------------------------#######################################################------------##------#----------------------
------------------------------------------------------------------------#########---------------------------------------------------------------------------####------------###-----#----------------------
-------------------------------------------------------------------##---------------------------------------------------------------------------------------####------------###----------------------------
-------------------------------------------------------------------------------------------------------------------------------------------------------------#########-------------------------------------
-----------------------------------------------------------------------------------------------------mm----------------------------------------------------------------------------------------------------
----------------------------------m---------------------------------------------------------------m--m-m---------------------------------------------------------------------------------------------------
-----------------------------------mmm---------------------------------------------------------m-mmmm---m----------------------------------------------------------------------------------------m-m-------
----------------------------------m###mmmm-------------------mm-------------------------------m--m-##----m--------------------------------------m-----------m----m--------------------mm-------mm-m-m------
---------------------------------m####BBB-m-----???M??------mmVmm-----B-----------------------mgm--##-----m----------------mm------------------m-mm--------mmmmmm-m-----mm----------mmm-m------m#-#--m-----
--------------------------------m#####-----m--------K----K-Km-[]-m----------------m----------m###--##------m--------------mm-mmmmm-------------mg--m------mC-####--m---mm-mmm------mm----m---mm-------m----
---------------mm--------------m######------m--------------mC-pP--m----m--mmm----mmm--------m####--##-------m-------------m-##-BBVmm----------m###--m----m#######---m--m-----m----mm-#----m--m#--------m---
--mmmmmmmmmmmmmk-mmmmmmmmmmmmmm#######-------mmmmmmmmmmmmmmmC-pP---mmmm-mm#+-mmmm#--mmmmmmmm#-###--##-----#--mmmmmmmmmmmmm--##---[]-mmmmmmmmmm####---mmmm#---####----mm-------mmmmm--#-----mm---------#-mmm
################################################################----#-#--##---#-#----#-##########--##-----#---##-##-#-##-#--##---pP--#-#-#########----#-##---####-----#------#-#-#---#------#-----------#-#
