------------------------------------------------------------------------------------------------####--#########################################################--------------------------------------------
-----------------------------------------------------------------------------------------------------------------------------------------------------------------------------------------------------------
-----------------------------------------------------------------------------------------------------------------------------------------------------------------------------------------------------------
---------------------------------------------------------------------------------------------------------------------------------------------------------------m-------------------------------------------
----------------------------------------mmm---------------------------B????-------------------------------------------------------------------------------------m------------------------------------------
---------------------------------------m#?-m------------------------------------------mm----------#-------m---------------------------------------------------m--m-----------------------------------------
--------------------------------------m##---m-----------------mmmm-------------------m##mm--------#---mm-m-m-------mm----------------------------------------m#---m-----------------mmm--------------------
-------------------------------------m###----m-----------------g#-m-----------------m##B#-m------m---mm--m--m-----mm-mm-------------------------------------m##----m---------------m#B-m-------------------
------------------------------------m####-----m---------------m##--?--?????-------mm###---mm-----#---m--m----m---mm----mmm---------------------mm----------m###-----m-------------m##---m------------------
-----------------------------------m#####------m-------------m###--m---------------####-----m----#mmm--##-----m--m-----[]-m-------------------m#-m--------m####------m-----------m###----m-----------------
----------------------------------m######-------mm-m--------m####---m-------------m####------m---####--##------mm------pP--m-----------------m##--m------m#####-------m---------m####-----m----mm-m--mm-m--
---------------------------------m#######-------#-m-mmmmmmmm#####----mmmmmmmmmmmmm#####-------m---###--##------[]------pP---m----m----mmmm--m###---m----m######--------mm-m---mm#####------mmmm#-m-mm#-m-mm
--mmmmmmmmmmmmmmmmmmmmmmmmmmmmmmm########-#############################################--------mmm###--##------pP------pP----mmmm-mmmm#[]-mm####----mmmm#######--------#-m-mmm#######------################
##########################################------------------------------------------------------#-###--##------pP------pP-----#-#--#-#-pP--#####-----#-########-#####################----##----------------
