-------------------------------------------------------------------------------------------------------------------------------------------------------------------------------############################
---------------------------------------------------------------------------------------------------------------------------------------------------------------#---------------############################
-------------------------------------------------------------------------------------------------------------------------------------------------------k-------#---------------############################
-------------------------------------------------------------------------------------------------------------------------------------------------------#------##---------------############################
--------------------------------------------------------------------------------------------------------------------------------------------#----------c------##---------------############################
-------------------------------------------------------------------------------------------------------------------------------------------*##########-c------##---------------###########################-
--------------------------------------------------------------------------------------------------M---------------------------------------M-?---------##------########################################----m
-------------------------------------------------------------------------------------------------------------------------------------------------------########----------------############----------mmmmm#
-------------------------------------------------------------------------------------------------------------------------------------------m------------------------------------#########--mmmmmmmmmm######
--------------------------------------------------m-----------------------------------------------mm--------------------------------------m#m------------------------------------#######mmm################
-----------------------------------m-------------mmmm-----------------------mm-------------------m#-m------------------------------------m#--m-----------------------mm----------------m###################
----------------------------------m-mmm---------m#-#-m----------mm----mmm--m#-m-------Kmm-----K--m#--m-----mm-m------mm------mmm---------m#---m--m--m--m-m--m--m--m--m-m--m--m--mmmmmmm####################
--mmmmmmmmmmmmmmmmmmmmmmmmmmmmmmmmg-gg-mmmmmmmmmm#-#--mmmmmmmmmmk-mmmmgk-mmm#--mmmmmmmmk-mmmmmmmmm#---mmmmm#-m-mmmmmmk-mmmmmmgg-mmmmmmmmmm#--#-mm-mm-mm-m-mm-mm-mm-mm---mm-mm-mm###########################
############################################################################################################################################----#--#--#-#--#--#--#--#----#--#--############################
