------------------------------------------#----------------------------------------------------------------------------------------------------------------------------------------------------------------
-----------------------------------------------------------------------------------------------------------------------------------------------------------------------------------------------------------
-------------------------------------------#---------------------------------------------------------------------------------------------------------------------------------------------------------------
-----------------------------------------------------------------------------------------------------------------------------------------------------------------------------------------------------------
------------------------------------------------------------------------------------------------------------M----------------------------M------------------------------M----------------------------------
---------------------------------------------------------mmmmmmmm------------------------------------------------------------------------------------------------------------------------------------------
--------------------------------------------------------m#######Km-----------------------------------------------------------------------------------------------------------------------------------------
-------------------------------------------------------m#######--#m-----------------------------------------mm---------------------------mm-----------------------------mm---------------------------------
-------------------------------------mmmmmmm----------m########--#-m------------------------m--------------m#-m-------------------------m#-m-------------------mm------m#-m--------------------------------
-------------?----------------------m#######mmmmmmmmmm############--m--mm----mm-----------mm-mm------mm----m#--m------mm--------mmm-----m#--m-----------mmm---m#-m-----m#--m---mmm-----mm-mmm----mm------mm
-----------------------------------m######-####################--#---mmk-mmmmk-mmmmmmmmmmmkg-k-mmmmmmk-mmmmm#---mmmmmmk-mmmmmmmmgg-mmmmmm#---mmmmmmmmmmmgg-mmmm#--mmmmmm#---mmmgg-mmmmmk-mgg-mmmmk-mmmmmmk-
-------------------------mm-------m#######--------------------------#######################################################################################################################################
--mmmmmmmmmmmmmmmmmmmmmmmg-mmmmmmm########-----------------------------------------------------------------------------------------------------------------------------------------------------------------
###########################################----------------------------------------------------------------------------------------------------------------------------------------------------------------
