-----------------------------------------------------------------#----############-------------------------------------------------------------------------------------------------------------------------
-----------------------------------------------------------------#####------------#------------------------------------------------------------------------------------------------------------------------
-----------------------------------------------------------------------------------------------------------------------------------------------------------------------------------------------------------
-----------------------------------------------------------------------------------------------------------------------------------------------------------------------------------------------------------
-----------------------------------------------------------------------------------------------------------------------------------------------------------------------------------------------------------
----------------------------------------------------------------------------------------------------------------------BBBBBBBB-----------------------------------------------------------------------------
-----------------------------------------M-------------------------------------------------------------------------------------------------M----------------------------------------------------M----------
-------------------------------------------------------------M---------------------------------------------------------------------------------------------------------------------------------------------
-----------------------------------------------------------------------------------------------------------------mmmmmmmmmmmm------------------------------------------------------------------------------
-----------------------------------------mm---------------------mm----------mmmmmmmm------------------------------###BBBBBBBBm-------------mm---------------------------------------------------mm---------
-----------------------------m----------m#-m-----------------mmmmmm--------m#######Cm-----------------m----------m###--------------------Km#-m-------------------------------------------------m#-m--------
-------------------mm------mm-mm--------m#--m----mmm--------m###--#m------m#######-#-m-------mm------m-mmm------m####---------m-----------m#--m-----mmm-------mm-------------mmm---------------m#--m-------
--mmmmmmmmmmmmmmmmmg-mmmmmmgg-g-mmmmmmmmm#---mmmmgg-mmmmmmmmm#-#--#-mmmmmm########--#-mmmmmmmg-mmmmmmg-gg-mmmmmmm####----------mmmmmmmmmmmm#---mmmmmgg-mmmmmmmk-mmmmmmmmmmmmmgg-mmmmmmmmmmmmmmmm#---mmmmmmm
################################################################--#--###-#########---######################################################################################################################
