-----------------------------------------------------------------------------------------------------------------------------------------------------------------------------------------------------------
-----------------------------------------------------------------------------------------------------------------------------------------------------------------------------------------------------------
-----------------------------------------------------------------------------------------------------------------------------------------------------------------------------------------------------------
--------------------------------mm-------------------------------------------------------------------------------------------------------------------------------------------------------------------------
-----------------------------mmm--m------------------------------------------------------------------------------------------------------------------------------------------------------------------------
-----------------------------m##?--m---------------------------------------------------------------------------------------------------------M----------------------------------mm-------------------------
----------------------------m###----m-----------------------------------------------------------------------------------------------mmm-----------------------------------------m-m------------------------
---------------------------m####-----m--------------------------------------------------------------------------m------------------mg#-m-----------------------------------------g-m-----------------------
--------------------------m#####------m-----------------------------------------------------mmm----?????--------mm-----------------m##--m-----------------mmm----------------mmm-#--m----------------------
------------?------------m######-------m---------------------------------------------------m[]-m--------------mm--m---------------m###---m---BB?---------mm[]mm------?????---m[]###--m---------------------
------------------------m#######--------mm-m--------mm--------mm----------------------mm---mpP--m-------------m#---m-------------m####----m---------K---mm-pP--m-------------mpP-##---m-------------------K
-----------------------m########--------#-m-mmmmmmmmg-mmmmmmmmk-mmmmmmmmmmmmmmmmmmmmmmk-mmmmpP---mmmmmmmmmmmmm-#--#-m------mm---m#####-----m------------m--pP---m------------mpP-###---mm-------mmm--------
--mmmmmmmmmmmmmmmmmmmmm#########-################################################################################----mmmmmmk-mmm######------mmmmmmmmmmmm---pP----mmmmmmmmmmmm-pP-###---g-mmmmmmmgg-mmmmmmmm
#################################-------------------------------------------------------------------------------------#######################################---###########################################
