---------------------------###############-----------------------------------------------------------------------------------------------------------------?###--------------------------------------------
--------------------------------------------------------------------------------------------------------------------------------------------------------------#--------------------------------------------
-----------------------------------------------------------------------------------------------------------------------------------------------------------m--#--------------------------------------------
----------------------------------------------------------mmm----------------------------------------------------------------------------------------------m---##------------------------------------------
---------------------------------------------------------m##-m-----------------------------------m---------------------------------------------------------m-----#-----------------------------------------
--------------------------------------------------------m###--m---------------------------------m----------------------------------------------------------m----m-#----------------------------------------
-------------------------------------------------------m####---m--------------------------------mgmm-------------------------------------------------------m-#mm---#---------------------------------------
------------------------------------------------------m#####?---m-------------------------------m##-m------------------------------------------------------m-###-m--#--------------------------------------
-----------------------------------------------------m######-----m--------?--------------------m###-----???????????-----------------------BBBBBBB----------m-###-----##-#-###-#----------------------------
----------BMB?--------------B-----------------mmmmmmm#######------m--------------------K----K-m####--m--------------------Kmmm--K-----mmmm----------------mm-###--m----#---#--------mm------------mm-------
-------------------mmm--K----BB----------mmmmm##############-------mm-m----------------------m#####---m-------------------m[]-m--------[]-m----------------Y-###-------------------mm-m-----mm---mm-m-----m
-------------------mC-m--mmm----------mmm###################-------#-m-mmmmmmmmmmmmmmmmmmmmmm######----mmmmmmmmmmmmmmmmmmmmpP--mmmmmmmmpP--mmmmmmmmmmmmmmmmy-###---m---m--m--m--m--m---m----m-m--m---m----m
--mmmmmmmmmmmmmmmmm-c--mmm#-mmmmmmmmmm##########################################################################################################################----mmm-mm-mm-mm-mm-----mmmm---mm-----mmmm-
#############################-##-#-#-########-----------------------------------------------------------------------------------------------------------------##----#-#--#--#--#--#------#-#----#------#-#-
