-----------------------------------------------------------------------------------------------------------------------------------------------------------------------------------------------------------
-----------------------------------------------------------------------------------------------------------------------------------------------------------------------------------------------------------
-----------------------------------------------------------------------------------------------------------------------------------------------------------------------------------------------------------
-----------------------------------------------------------------------------------------------------------------------------------------------------------------------------------------------------------
-----------------------------------------------------------------------------------------------------------------------------------------------------------------------------------------------------------
-------------------------------------------------------------------------------------------------------------------------------------------------------------------------*BB-------------------------------
--------------------------------------------------------------------------------M----------------------------------------------------------------------------------------*---------------------------------
-------------------------------------------------------------------------------------------------------------------------------------------------------------------------m---------------------------------
------------------------------------------------------------------------------------------------------------m-----------------------------------------------------------mmm--------------------------------
--------------------------------------------mmm---------------------------------m--------------------------mmm----------------------------------------------------------m?---------------------------------
--------------------------------m----------m[]-m-----K-------m----------mmm----m#m------------------------m#--m----------------------------mm----------------m---------m---m-----------------------KK--K-mm
-------------------------------m-mmm-------mpP--m-----------m-mmm-------m#-m---m#-----mmm-------mm--------m#---m--------------------------m#-m-----mm------mm-mmm-----m#-------------mmm------------------#
--mmmmmmmmmmmmmmmmmmmmmmmmmmmmmg-gg-mmmmmmmmpP---mmmmmmmmmmmg-gg-mmmmmmm-#--mmmm#-mmmmgg-mmmmmmmk-mmmmmmmmmpP-#-mmmmmmmmmmmmmmmmmmmmmmmmmmm#--mmmmmk-mmmmmmkg-gg-mmmmmm#-k--mmmmmmmmmgg-mmmmmmmmmmmmmmmmmm#
###########################################################################################################################################################################################################
