-----------------------------------------------------------------------------------------------------------------------------------------------------------------------------------------------------------
-----------------------------------------------------------------------------------------------------------------------------------------------------------------------------------------------------------
-----------------------------------------------------------------------------------------------------------------------------------------------------------------------------------------------------------
-----------------------------------------------------------------------------------------------------------------------------------------------------------------------------------------------------------
-----------------------------------------------------------------------------------------------------------------------------------------------------------------------------------------------------------
------------------------------------------------------------------------------------------------------------------------------------------+----------------------------------------------------------------
---------------------------------M-------------------------------------------------------------------------------------------------------------------------------------------------------------------------
-----------------------------------------------------------------------------------------------------------------------------------------------------------------------------------------------------------
-----------------------------------------------------------------------------------------------------------------------------------------------------------mmm---------------------------------------------
---------------------------------mm-------------------mmm--------------------mmm---------------------------------------BBBBBBBB-----------mmm-------------mm[]m--------------------------------------------
-----------------------------K--m#-m-----------------m[]-m------mmmm--------m[]-m-----------mmmm------------------mmmm-------------------m[]-m-----------mm-pP-m-------------------------------------------
---------------------mm---------m#--m------mmm-------mpP--m-----m[]-m-------mpP--m-----------[]-m---Kmm------------[]-m------------mm----mpP--m----------mC-pP--m---mmm----mm--mmm----mmm-------mmm--------
--mmmmmmmmmmmmmmmmmmmg-mmmmmmmmmm#---mmmmmmgg-mmmmmmmmpP---mmmmm-pP--mmmmmmmmpP---mmmmmmmmmmmpP--mmmmh-mmmmmmmmmmmmpP--mmmmmmmmmmmmh-mmmmmpP---mmmmmmmmmm-c-# ---mmmgg-mmmmg-mmgg-mmmmgg-mmmmmmmgg-mmmmmmmm
###########################################################################################################################################################################################################
