-------------------------------------------------------------######################---------------------------------------------------------------------------------------------##-------------------------
-----------------------------------------------------------------------------------#-----------------------------------------------------------------------------------------------------------------------
-----------------------------------------------------------------------------------------------------------------------------------------------------------------------------------------------------------
------------------------------------------------------------------------------------#-----------------------------------------------------------------m--------------------------------------------------m-
---------------------------------------------------------------------------------------------------------------------------------------------------mmm-m-----------------------------------------------mm-m
--------------------------------------------------------------------------------------------------------------------------------------------------m###--m---------------------------------------------m##--
-------------------------------------------------------------------------------------------------------------------------------------------------m####---m-------------------------------------------m###--
------------------------------------------------------------------------------------?B----------------------------------------------------------m#####----m-------------------mm--------------------m####--
----------------------------------------------------------------------------------------#---------------------------------------------------m--m######-----m-----------------m#?m------------------m#####--
-------------------------------------------------------------------mmmmmmmmmmmmmmmmmm-##-#------------------------??BBB----------------------mm#######----------------------m##-?m----------------m######--
------------------------------------------------------------------m#################Cmm--------------------mmmm-----------------------------m#########------m--------------m###--?m--------------m#######--
--------------------mm----mm-------mm---------------mm------mmm---m################-##mm--------mm-m-------m[]-m---------------------------m##########------------------mmm####----m------------m########--
--mmmmmmmmmmmmmmmmmmk-mmmmk-mmmmmmmk-mmmmmmmmmmmmmmmk-mmmmmmgg-mmm#################-----mmmmmmmm#-m-mmmmmmm-pP--mmmmmmmmmmmmmmmmmmmmmmmmmmm###########-------mmmmmmmmmmm#######-----mmmmmmmmmmmm#########--
###################################################################################-----#-########################################################################################---######################
