-----------------------------------------------------------------------------------------------------------------------------------------------------------------------------------------------------------
-----------------------------------------------------------------------------------------------------------------------------------------------------------------------------------------------------------
-----------------------------------------------------------------------------------------------------------------------------------------------------------------------------------------------------------
-----------------------------------------------------------------------------------------------------------------------------------------------------------------------------------------------------------
-----------------------------------------------------------------------------------------------------------------------------------------------------------------------------------------------------------
-----------------------------------------------------------------------------------------------------------------------------------------------------------------------------------------------------------
------------------------------------------B------------------------------------------------------------------------------------ooB-------------------------------------M-----------------------------------
-----------------------------------------------------------------------------------------------------------------------------------------------------------------------------------------------------------
-----------------------------------------------------------------------------------------------m--mmmmmmm--------------------------------------------------------------------------------------------------
----------------------------------------mmmm--???????-------------------------------------------mm######-m---------------------mmm-------------------------------------mm----------------------------------
--------------------------------------mmmmm-m--------------mm-------mmmmmmmmmmmmmmmmmmmmmmmmmmmm########--m-------------------m[]-m---------------mmmm---------mmm----m#-m---------------------------------
--------------------------------------m#--#--m------------m#-m--K--m####################################---m--------mm--------mpP--m------mmm-----m[]-m---------#-m---m#--m------------mmm------------mmm--
--mmmmmmmmmmmmmmmmmmmmmmmmmmmmmmmmmmmm-#--#---mmmmmmmmmmmmm#--mmmmmm#-##################################----mmmmmmmmk-mmmmmmmmmpP---mmmmmmgg-mmmmm-pP--mmmmmmmmm#--mmmm#---mmmmmmmmmmmmgg-mmmmmmmmmmmmkg-mm
###########################################################################################################################################################################################################
