-----------------------------------------------------------------------------------------------------------------------------------------------------------------------------------------------------------
-----------------------------------------------------------------------------------------------------------------------------------------------------------------------------------------------------------
-----------------------------------------------------------------------------------------------------------------------------------------------------------------------------------------------------------
----------------------------m------------------------------------------------------------------------------------------------------------------------------------------------------------------------------
------------------------mmmm-m-----------------------------------------------------------------------------------------------------------------------------------------------------------------------------
-----------------------m####--m----------------------------------------------------------------------------------------------------------------------------------------------------------------------------
----------------------m#####---m---------------------------------------------------------------------------------------------------------------------------------------------------------------------------
---------------------m######----m--------------------------------------------------------------------------------------------------------------------------------------------------------------------------
--------------------m#######?----m---------------------------------------------------------------------------------------------------------------------------------------------------------------------mmm-
---------BBB-------m########------m------???M?---------mmm------------------------mm-----------------------------------------------------------------------------m-------------------------------------m[]m
------------------m#########-------m------------------m[]-m-------mmmm-----------m#-m------------------------------mmm------------------------------------------m-m---K------K---K--mmmm-----------K--m-pP-
-----------------m##########--------mm-m---------mm---m[]--m-------[]-m----------K#--m----mm-m----------------------#-m--------------mm-------------K-----mm----m--m---------K-------[]-m--------K----m-pP-
--mmmmmmmmmmmmmmm###########--------#-m-mmmmmmmmmg-mmmmpP---mmmmmmmpP--mmmmmmmmmmm#---mmmm#-m-mmmmmmmmmmmmmmmmmmmmmm#--mmmmmmmmmmmmmmk-mmmmmmmmmmmmmmmmmmmk-mmmmm---mmmmmmmmmmmmmmmmmc---mmmmmmmmmmmmmm-pP-
###########################################################################################################################################################################################################
