-----------------------------------------------------------------------------------------------------------------------------------------------------------------------------------------------------------
-----------------------------------------------------------------------------------------------------------------------------------------------------------------------------------------------------------
-----------------------------------------------------------------------------------------------------------------------------------------------------------------------------------------------------------
-----------------------------------------------------------------------------------------------------------------------------------------------------------------------------------------------------------
-----------------------------------------------------------------------------------------------------------------------------------------------------------------------------------------------------------
------------------------------------------------------------------------------------------------BB---------------------------------------------------------------------------------------------------------
-------------------------------------------------------------M---------------------------------------------------------------------------------------------------------------------------------------------
-----------------------------------------------------------------------------------------------------------------------------------------------------------------------------------------------------------
-------------------------------------------------------------------------mm------------mmm--------k------------------------------------------K-------------------------------------------------------------
-------------------------------------------------------------mm---------mm#mm---------mm[]mm------?B-----------------------------------------------BBBB---------mm-----------------------------------------
-------------------------------m---------mmmmm--------------m#-m-------mm-#--m-------mm-pP--m-----------------------------------------------mmmm---------------m#-m-----------------K----------------------
-----------------------------mm-mm-------m[]#-m-------------m#--m--mm--m--#---m-----Km--pP---m---mm-m---mmm--------mm-----mm-----mm----------[]-m--------------m#--m---mmm-------------------mm------------
--mmmmmmmmmmmmmmmmmmmmmmmmmmmgg-g-mmmmmmm-pP#--mmmmmmmmmmmmmm#---mmk-mm---#----mmmmmm---pP----mmmk-m-mmmgg-mmmmmmmmk-mmmmmg-mmmmmk-mmmmmmmmmmpP--mmmmmmmmmmmmmmm#---mmmgg-mmmmmmmmmmmmmmmmmmmk-mmmmmmmmmmmm
############################################################################################--#############################################################################################################
