-----------------------------###-----------------------------------------------------------------------------------------------------------------------------------------------############################
------------------------------##---------------------------------------------------------------------------------------------------------------------------------------------------------------------------
-----------------------------------------------------------------------------------------------------------------------------------------------------------------------------------------------------------
---------------------------------------------------------------------------------------------------------------------------------------------------------------------------#-------------------------------
--------------------------------------------------------------------------------------------------------------------------------------------------------------------------m##------------------------------
--------------------------------------------------------------------------------------------------------------------------------------------------------------------------##-------------------------------
------------------------------?-------------------------------------------------M-----------------------------------------------------------------------------------------#--------------------------------
---------------------------------------------------------------------------------------------------------------------------------------------------------------------------m-------------------------------
----------------------mmmmmmmm-----------------------------------------------------------mmm--+-------------------------------------------------------------------------mm-#m------------------------------
---------------------m########m-------------------------------------------------mm------mm[]mm-------------------------------------------------------------------m-m-mm-m#m##m-------mmmmmmmmm-------------
--------------------m########-?m--------------------K----------------------K---m#-m----mm-pP--m-------------------------????------------------------------------mmmmmmmm-####-m-----m########-m------------
-----------------mmm#########------------mmm----------mmm-------mm-----mm------m#--m---m--pP---m-------mmm-------mm------------mmm------------------mm---mmm---m#-#-#--#---###-m---m#########--m-----------
--mmmmmmmmmmmmmmm############---mmmmmmmmmkk-mmmmmmmmmmkk-mmmmmmmk-mmmmmk-mmmmmmm#---mmm---pP----mmmmmmmgg-mmmmmmmk-mmmmmmmmmmmmgg-mmmmmmmmmmmmmmmmmmk-mmmgg-mmmm#-#-#---------#-mmm##########---mmmmmmmmmmm
##############################--#-###################################################################################################################################----------##-###########----#-#-#-#-#-
