---------------------------------------------------------------------------------------------------------------------------------------------------------------------#####################-----------------
----------------------------------------------------------------------------------------------------------------------------------------------------------------------------------------------#############
-----------------------------------------------------------------------------------------------------------------------------------------------------------------------------------------------------------
-----------------------------------------------------------------------------------------------------------------------------------------------------------------------------------------------------------
-----------------------------------------------------------------------------------------------------------------------BBMM?BBBBBBBB-----------------------------------------------------------------------
---------------------------------------------------------------------------------------------------------------m----------------------M--------------------------------------------------------------------
---------------------------------------m--------------mmm----------------------------------------------------M--m------------------------------------------------M-----------------------------------------
------------------------------------mmm-m------------m[]-m-----------------------------------------------------m-m-----------------------------------------------------------------------------------------
-----------------------------------mm#B--m-----------mpP--m------??-------------------------------------------m#--m----BBBBBBBBBBBBB--m--------------------------------------------------------------------
----------------------------------mm-#+---mm---mm----mpP---m---------------------------m---------------------m##---m-----------------m#m------------------------mmmm-----mmmmmmmmmmmmmmmmmmmm--------------
----------------------------------m--#-B--B-mmmk-mmmmmpP----mmmmmmmm---mmm-----------mm-mm----mmm-----------m###----m----------------m#-m----------mm------------###m---m#################BB-m-------------
-------------mm------------------m---#+----########################-mmmgg-mmmmmmmmmmmgg-g-mmmmgg-mmmmmmmmmmmm#-#-----mmmmmmmmmmmmmmmmm#--mmmmmmmmmmk-mmmmmmmmmmmm#-#---m##################----m------------
--mmmmmmmmmmmk-mmmmmmmmmmmmmmmmmmg-g-#----------------------------###################################################################################################mm###################-----mmmmmmmmmmmm
#######################################------------------------------------------------------------------------------------------------------------------------------#####################------##-#-#-#-#-
