-------------------------------------------#####-----------------------------------------------------------------------------------------------------------------------------------------------------------
-----------------------------------------------------------------------------------------------------------------------------------------------------------------------------------------------------------
-----------------------------------------------------------------------------------------------------------------------------------------------------------------------------------------------------------
-----------------------------------------------------------------------------------------------------------------------------------------------------------------------------------------------------------
-----------------------------------------------------------------------------------------------------------------------------------------------------------------------------------------------------------
-----------------------------------------BBB-------------------------------------------------BB------------------------------------------------------------------------------------------------------------
------------------------------------------oBBBB?--------------------------------------------B-----------------------------------------------------------------------------------M--------------------------
-----------------------------------------------------------------------------------------------------------------------m--------------------#--------------------------------------------------------------
----------------------------mm-----------------------------------------------------------------k----------------------m--------------------M---------------------------------------------mmm---------------
---------------------------mm-m----------mmm------------------------------------------------m#BBBBB-------------------m#m-------------------------------------------------------mm------mm[]mm---?---------
--------------------------mm---m------K-m[]-m--------------K--------------m----------------m#m------------m----------mm#-m----------------m-----------------------------mmm----m#-m----mm-pP--m---???M??---
--------------------------mC----m-------mpP--m---------mm-----mm--------mm-mm--------------m#-m--------K---mm---------##--m-------mm-------mm--------mm-------mm---------#-m---m#--m---m--pP---m--------mmm
--mmmmmmmmmmmmmmmmmmmmmmmm-c-----mmmmmmmmpP---mmmmmmmmmg-mmmmmg-mmmmmmmmgg-g-mmmmmmmmmmmmmmmc--mmmmmmmmmmmm#-mmmmmmmmm-#---mmmmmmmg-mmmmmmm#-mmmmmmmmk-mmmmmmmk-mmmmmmmmm#--mmmm#---mmm---pP----mmmmmmmmgg-
#############################################--############################################################################################################################################################
