-------------------------------------###-------------------#--##----#--------------------------------------------------------------------------------------------------------------------------------------
--------------------------------------#######################-##----#--------------------------------------------------------------------------------------------------------------------------------------
-------------------------------------------------------------#########------------------------------------------------------------------------------m------------------------------------------------------
-----------------------------------------------------------------------------------------------------------------------------------------------mmmmm-m-----------------------------------------------------
----------------------------------------------------------------------------------------------------------------------------------------------m####g--m----------------------------------------------------
---------------------------------------------------------------------------------------------------------------------------------------------m######---m---------------------------------------------------
------------------------------------M-------------------------------------------------------------------------------------------------------m#######----m--------------------------------------------------
--------------------------------------mm-------------------------------------------------------------------------------------------------mmm########-----m-------------------------------------------------
-------------------------------------mm-----------------------B---------------------------------------------------------------------------g#########?-----m------------------------------------------------
------------------------------------m#--mm-----------------------------------------------------------mmm----B?B?MB-----------------------m##########-------m------------------------mmmm--------------mmm--
-----------------------------mmm---m#--##-m------------------m--------------------------------------m[]-m-------------K-----------------m###########--------mm-m------mm------------m[]-m------------m[]-m-
--------------------mm-------m#-m--m?--##--m-----------------mmmm--mm-------------mm----------------mpP--m-------mm----mm-----mmm------m############--------#-m-mmmmmmg-mmmmmmmmmmmm-pP--mmmmmmmmmmmmmpP--m
--mmmmmmmmmmmmmmmmmmg-mmmmmmm-#--mmm---##---mmmmmmmmmmmmmmmmm-?##mmM-mmmmmmmmmmmmmk-mmmmmmmmmmmmmmmmmpP---mmmmmmmh-mmmmg-mmmmmgg-mmmmmm#############-######################################################
######################################-##----#-#-#-#-#-#-#-##--##-#--################################################################################------------------------------------------------------
