----------------------------------------------------------------------------------------------------------------------------------------------#############------------------------------------------------
---------------------------------------------------------------------------------------------------------------------------------------------------#########-----------------------------------------------
-----------------------------------------------------------------------------------------------------------------------------------------------------------------------------------------------------------
-----------------------------------------------------------------------------------------------------------------------------------------------------------------------------------------------------------
-----------------------------------------------------------------------------------------------------------------------------------------------------------------------------------------------------------
-------------------------------------------------------------------------------------------------------------------------------------------------------------m---------------------------------------------
---------------------------------------------------------------------M----------------------------------------M------------------------------M------------mmm-m--------------------------------------------
---------------------------------------------------------------------------------------------------------------------------------------------------------m##?--m-------------------------------mm----------
-----------------------------------------------------------------------------------------------------m--------------------------------------------------m###----m-----------------------------mm#mmBB?M?M??
-------B??-------------------------------------mmm-------------------mm-------------------------------m-------mm-----------------------------mm--------m####-----m--------------------K------mm-#--m-------
------------------------------m---------------m[]-m--------mm-------m#-m------------m---------------mm-------m#-m---------------------------m#-m------m#####------m-----------mmm------------m--#---m------
-----------------------------m-mmm------------mpP--m------m#-m------m#--m---------mm-mm--------------#-m-----m#--m-------------mm-----------m#--m----m######-------mmmmmmmmmmmgg-mmmmmmmmmmmm---#----mmmmmm
--mmmmmmmmmmmmmmmmmmmmmmmmmmmg-gg-mmmmmmmmmmmmmpP---mmmmmmm#--mmmmmmm#---mmmmmmmmmgg-g-mmmmmmmmmmmmmm#--mmmmmm#---mmmmmmmmmmmmmk-mmmmmmmmmmmm#---mmmm#######------#########################################
################################################################################################################################################--#-########-----------------------------------------------
