------------------------------########################################################################################################------------------------------#####################------------------
--------------------------------------------------------------------------------------------------------------------------------------#--------------------------------------------------------------------
-----------------------------------------------------------------------------------------------------------------------------------------------#-----------------------------------------------------------
---------------------------------------------------------------------------------------------------------------------------------------#--------##---------------------------------------------------------
------------------------------------------------------------------------------------------------m----------------------------------------------------------------------------------------------------------
---------------------------BBB--------------------------------------------------------------mmmm-m---------------------------------------------------------------------------------------------------------
----------------------------------------mm-------------------------------------------------m###g--m--------------------------------------------------------------------------------------------------------
---------------------------------------m#?m-----------------------------------------------m#####---m----------------------------------------------------------------------------------------mm-------------
--------------------------mm----------m##--m---------------------------------------------m######----m--------------------------------------------------------------------------mmm----------m-m------------
-------------------------mm#m--------m###---m-------------------------mmm---------------m#######-----m--------------------------mmmmmmmmmm----------mm-------mm---------------m#B-m-------mm---m-----------
------------------------mm-#+m------m####----m-----------------------m##-m-------------m########------m------------------------m#######Cm-mo--mm---mm-m-----mm-m-------------m##---m-----mm#----m-----mm---
------------------------m--#--m----m#####-----m---------------------m###--------------m#########-------m-------------------m--m#######-#---m--m-m--m---m----m---m--------m--m###----m----m-------mmmmmk-mmm
--mmmmmmmmmmmmmmmmmmmmmm---#---mmmm######------mmmmmmmmmmmmmmmmmmmmm####--mmmmmmmmmmmm##########--------mmmmmmmmmmmmmmmmmmm-mm########------mm---mm-----mmmm-----mmmmmmmm-mm####-----mmmm--------##########
#############################---#-#######------k-#-#-#-#-#-#-#-#-#-#####---#-#-#-#-#-###########--------#-#-#-#-#-#-#-#-#-#--#########-------#----#------#-#------#-#-#-#--#####------#-#------------------
