--------------------------------##########################################################################################---------------------------------------------------------------------------------
-----------------------------------------------------------------------------------------------------------------------------------------------------------------------------------------------------------
-----------------------------------------------------------------------------------------------------------------------------------------------------------------------------------------------------------
-------------------------------------------------------------------------------------------------------------------------------------------------------------------------------------mmmmmmm---------------
------------------------------------------------------------------------------------------------------------------------------------------------------------------------------------mm#####----------------
----------------------------------------------mmm-----------------------------------------mmmmm---------------------------------------------------------------------?---------------m-#####-m--------------
---------------------------------------------m##-m---------------------------------------m####?------------------------------------------------------------------------------------m--#####--m-------------
--------------------------------------------m###--m-------------------------------------m#####------------------------------------------------------------------------------------m#--#####V--m------------
------------------------mm-----------------m####---m-----------------------------------m######-------------------------------mmm--#-k--------------------------------------------m##--#####[]--m------???M?
-----------????---------m#m----BMB--------m#####?---m---------------------------------m#######?-----------------------------mm[]mm??????????M???????????--???????????------B----m###--#####pP---m----------
-----------------mmm----m#-m-------------m######-----m-------------------------------m########-----------------------------mm-pP--m--------------------------------------------m####--#####pP----m-m-------
-----------------mC-m--m##--m-----------m#######------m---------m--------------mmm--m#########-----------m----------------mm--pP-------mmm--mm----mm------mm------------mmm---m#####--#####pP---#-m-mmmmmmm
--mmmmmmmmmmmmmmm-c--mmmC#---mmmmmmmmmmm########-------mmmmmmmmm-mmmmmmmmmmmmmm##-mm##########----mmmmmmm-mmmmmmmmmmmmmmmm#---pP---mmmmgg-mmg-mmmmg-mmmmmmk-mmmmmmmmmmmmgg-mmm######--#####################
##################################-#-#-#########-------#-#-#-#-#--#-#-#-#-#-#-#-#--###########----#-#-#-#--#-#-#-#-#-#-#-#-#########################################################-----------------------
