--------------------------------------------------------------------------###########################################------------------#--------------------#-----------############################-------
--------------------------------------------------------------------------------------------------------------------####################################################-----------------------------------
-----------------------------------------------------------------------------------------------------------------------------------------------------------------------------------------------------------
-----------------------------------------------------------------------------------------------------------------------------------------------------------------------------------------------------------
-----------------------------------------------------------------------------------------------------------------------------------------------------------------------------------------------------------
-----------------------------------------------------------------------------------------------------------------------------------------------------------------------------------------------------------
-----------------------------------------------------------------+-----------------------------------------------------------------------------------------------------------------------------------------
------------------------------------------------------------------------------------------------------------------------------------------------------------------------------------------mm---------------
-----------------------------------------------------mm----------------------------------------------------------------------------------------------------------------------------------m#-m---------mm---
-------------------------BBBB-mm--------------------mm-m---------mmm----------------------------------mmmmmmm--------------------------------------------------------------mm-----------m##--m-------mm-mmm
-------------------mmmm------mC-m-----K------------mm---m----K--m[]-m---mmm--------------mm----------m######-m------------------------------------------------------------mm#mm???-----m###---m-----mm-----
-------------------m[]-m-----mc--m-----mm--mmm------c----m------mpP--m--mC-m------------mm#m------mmm#######--m----mm-----------------------------------------------------m-#--m------m####----m----m------
--mmmmmmmmmmmmmmmmm-pP--mmmmmmC---mmmmmh-mmgg-mmmmmmC-----mmmmmmmpP---mm-c--mmmmmmmmmmmm#-#-mmmmmm##########---mmmm#-mmmmmmmmmmmmmmmmmmmmmmmmmmmmmmmmmmmmmmmmmmmmmmmmmmmmm--#---mmmmmm#####-----mmmm-------
############################################################################-#-#-#-#-#-#--#--#-#-#-k########----#-#--##-#-#-##-#-#-#-#-##-#-#-#-#-#-#-#-#-##-#-#-#-#-#-###--#----#-#-######------#-#-------
