--------------------------------------------------############-------------#-------------------#-----###------------############################-#-#--------#---#----##-------#############################
----------------------------------------------------------------##########################-----#-----###---------------------------------------###############--#----##------------------------------------
----------------------------------------------------------------------------------------------##########------------------------------------------------------#####--##------------------------------------
-----------------------------------------------------------------------------------------------------####--###-------------------------------------------------------##------------------------------------
---------------------------------------------------------------------------------------------------------------------------------------------------------------------###-----------------------------------
-----------------------------------------------------------------------------------------------------------------------------------------------------------------------------------------------------------
--------------------------------------------M-mm-----------------------------------------------------------------------------------------------------------------------------------------------------------
---------------------------------------------mm-m----------------------------------------------------------------------------------------------------------------------------------------------------------
---------------------------------------------m---m-------------------------------------------------------------------k-------------------------------------------------------------------------mmm---------
--------------------------------------------m-----m--------mmmmmm------------------------------------mm--------mm----#----------------------------------------------------B---#---------------m#B-m--------
-------------------------------------------m#------m------m###BB-m----------------------------------mm-mm------m-m---#----------------------------------------mmm--------B-------------------m##---m-------
-----------------------------mm------------m#-------m----m####----m--------------------------m--mm--m----mm--mm---m------m-----m-----mm-------mm--------------m?-m--mm-------m------m--mmm--m###----m------
--mmmmmmmmmmmmmmmmmmmmmmmmmmmk-mmmmmmmmmmmmmC--------mmmm#####-----mmmmmmmmmmmmmmmmmmmmmmmmmm-mm#-mm?-##---mm##----mmmmmm-mmmmm-mmmmm#-mmmmmmm#-mmmmmmmmmmmmmm----mmmmmmmmmmm-mmmmmm-mm##-mm####-----mmmmmm
#############################################--#------#-######------##-#-#-##-#-#-#-##-#-##-#--##--#--###---#?#-----#-#-#---#-#---#-#--#-#-#-#--#####-#-#-#-##---#-#--#####-#--#-#-#--#----#####------#-#-#
