--------------------------------------------------------------------------------------------------------------------------------------------------------------------------------------------------#########
-------------------------------------------------------------------------------------------------------------------------------------------------------------------------------#---------------------------
-----------------------------------------------------------------------------------------------------------------------------------------------------------------------------------------------------------
--------------------------------------m----------------------------------mm--------------------------------------------------------------------------------------------------------------------------------
------------------------------------mm-m--------------------------------m?---------------------------------------------------------------------------------------------------------------------------------
-----------------------------------m##--m------------------------------mB--m-------------------------------------------------------------------------------------------------------------------------------
----------------------------------m###---m----------------------------m#?---m-----------------------------------------------------------------------------------------------BB-----------------------------
---------------------------------m####----m--------------------------m##-----m---------------------------------------------------------------------------------------------------------------m-------------
--------------------------------m#####-----m------------------------m###------m-----------------------------------------------------------------------------mmmmm----------oo-----------------mm-----------
-------------------------------m######------m-----------------------m###-------m---------------------------------------------------------------------------m####-m----BBB--mm----------------mg-m----------
------------------------------m#######-------m----------------------m###--------m---------------------mmm----------mm----------------mm-m-------------mmmmm#####--m-------mm-m----mm--------m##--m---------
-----------------------------m########--------mm-m-mm-m--------mm--m####---------mm-m-----------------m#-m--------m#-m--------------m#-m-mm------mm--m##########---m------m---m--mm-m------m####--m--------
--mmmmmmmmmmmmmmmmmmmmmmmmmmm#########--------#-m-m#-m-mmmmmmmmg-mm#####-##------#-m-mmmmmmmmmmmmmmmmm-#--mmmmmmmmm#--mmmmmmmmmmmmmmm#-k-k-mmmmmmk-mmmpP########----mmmmmm-----mmm---mmmmmm#####---mmmmmmmm
#########################################################################--###############################################################################################------#-----###########---#-#-#-#
