--------------------------##---------------------------------------------------------------##--------------------------------------------------------------------------------------------------------------
----------------------------#--------------------------------------------------------------###-------------------------------------------------------------------------------------------------------------
-----------------------------------------------------------------------------------------------------------------------------------------------------------------------------------------------------------
-----------------------------------------------------------------------------------------------------------------------------------------------------------------------------------------------------------
---------------------------------------------------------------mm------------------------------------------------------------------------------------------------------------------------------------------
------------------------*B------------------------------------mB-m-----------------------MB*---------------------------------------------------------------------------------------------------------------
-------------------------------------------------------------m#---m----------------------------------------------------------------------------------------------------------------------------------------
------------------------mmmm-------------------------------mm##----m----------------------------------------------------------------------------------------------------------------mmmmmm-----------------
-----------------------mm###m-----------------------------mg###-----m---------------------mm---------------------------------------------------------------------------------------mm---[]m----------------
-----------------------m?-###m----------------------------m####------m-------------------m#?m-----?-------------------------------------------------------------------------------mm----pP-m----????????---
----------------------m---##+---------------m-------------m####-------m-----------------mm---m-------------------------------K----------K--K--------------------------------------m-----pP--m--------------
---------------mm----m#---##--m----m-mm-m--m-mm----------m#####--------mm---------------K#---------------mm-----mm-mm-------------mm----------mm-------mm-----------------mm-----m------pP---m----mm-----mm
--mmmmmmmmmmmmmk-mmmmm#---##---mmmm-m#-m-mmk-k-mmmmmmmmmm######--------g-mmmmmmmmmmmmmmmm#----mmmmmmmmmmmk-mmmmmk-mk-mmmmmmmmmmmmmk-mmmmmmmmmmk-mmmmmmmk-mmmmmmmmmmmmmmmmmk-mmmmmg------pP----mmmmk-mmmmmgg
############################----############################################################-#-############################################################################################################
