-----------------------------------------------------------------------------------------------------------------------------------------------------------------------------------------------------------
-----------------------------------------------------------------------------------------------------------------------------------------------------------------------------------------------------------
-----------------------------------------------------------------------------------------------------------------------------------------------------------------------------------------------------------
-----------------------------------------------------------------------------------------------------------------------------------------------------------------------------------------------------------
-----------------------------------------------------------------------------------------------------------------------------------------------------------------------------------------------------------
---------------------------------------------------------------------------------------------------------------------------------------------------------------+-------------------------------------------
--------------------------------------------------------------------------------------------------------------------------------------------------------------------------------------M--------------------
-----------------------------------------------------------------------------------------------------------------------------------------------------------------------------------------------------------
--------------------------------------------------------------------------------mm---------mm--------------------------------------------------------------------------------------------------------------
-----------------------------------------------mmm-----------------------------mm-mmm-----mm-mmmmm----------------------------------------mmm----BBBBBB--------mmm--------------------mm-------------------
--------------------------------------mmm--K--m[]-m---------------------------mm-----m---mm----[]-m------------mmm---K-------------------m[]-m-----------K----m[]-m------------------m#-m------------------
--------------------------------------mC-m----mpP--m--------mm-----mmm---------C------m--mC----pP--m----------m[]-m----------------------mpP--m---------------mpP--m-----mmm---------m#--m--mm-------mmm---
--mmmmmmmmmmmmmmmmmmmmmmmmmmmmmmmmmmmm-c--mmmmmpP---mmmmmmmmh-mmmmmgg-mmmmmmmmmc-------mm-c----pP---mmmmmmmmmmmpP--mmmmmmmmmmmmmmmmmmmmmmmpP---mmmmmmmmmmmmmmmmpP---mmmmmgg-mmmmmmmmmm#---mmk-mmmmmmmgg-mmm
###########################################################################################################################################################################################################
