---------------------------------------------------------------------------------------------------------------------------------------------------------------##############------------------------------
-----------------------------------------------------------------------------------------------------------------------------------------------------------------------------#-----------------------------
-----------------------------------------------------------------------------------------------------------------------------------------------------------------------------------------------------------
--------------------------------------------------------------------#--------------------------------------------------------------------------------------------------------------------------------------
-----------------------------------------------------------------------------------------------------------------------------------------------------------------------------------------------------------
-------------------------------------------------???????BB??M----------------------------------------------------------------------------------------------------------------------------------------------
--------------------------------------------------------------------------------------------------------------------M----------------------------------------BB--------------------------------------------
--------------------------------------mmmm-----------------------------------------------------------------------------------------------------------------------------------------------------------------
-------------------------------------mg#+-m-----------------------------mm---------------------------------------------------------------------------------------------------------------------------------
-------------------------------------m##---m-----????????????M--mm-----mm-m---------K-------------------------------mm---------------------------------------mm-----------mmmmm----------------------------
-------------------------------------m##----m--------------K---mm-m----m---m------------------------------------K--m#-m-------------------------------------m#-m---------m#####mm---mm---------------------
---------------------mm-------------m###-----mm----------------m---m--m-----m-----------mm--------mm---------------m#--m-----mmm-------mm------mm--mmm------m#--m--mmmmmm####-##-m--m-m----m-m---mm------mm
--mmmmmmmmmmmmmmmmmmmk-mmmmmmmmmmmmm####-----g-mmmmmmmmmmmmmmmm-----mm#------mmmmmmmmmmmk-mmmmmmmmk-mmmmmmmmmmmmmmmm#---mmmmmgg-mmmmmmmk-mmmmmmk-mmgg-mmmmmmm#---mm##########-----mm---mmmm-m-mmmk-mmmmmmg-
###############################################################------#-----######################################################################################-###########------#----#-#################
