------------------------------------------------------------#################################################################################--------------------------------------------------------------
-----------------------------------------------------------------------------------------------------------------------------------------------------------------------------------------------------------
-----------------------------------------------------------------------------------------------------------------------------------------------------------------------------------------------------------
---------------------------------------------------------mm------------------------------------------------------------------------------------------------------------------------------------------------
--------------------------------------------------------mm-m-------------------------------------------------------------m---------------------------------------------------------------------------------
---------------------BBBB?BBBBB--------?M??------------mm---m-------------m--------------------------------------------mm-m--------------------------------------------------------------------------------
-----------------mm------------------------------------m-----------------m-m--------------------mm--------------------m##--m-------------------------------------m---mm------------------------------------
-----------------mgmmm------------------------------m-m------m----------m#--m------------------mm-mmmm---------------m###---m-------------------------------------m--m-m-----------------------------------
-----------------mgg#-mmmmmmmmmmm------------------m-m#B---------------m##---m----------------mm------m-------------m####----m------------mm---------------------mgmm--------------------------------------
----------------m#####???????BBB-m--?M???????------mg##------#m-------m###----m-----------mm--m--------m-----------m#####-----m----------mm-m--------------------m###---mmmmmmmmmmmmmmmmmmmmmmmmmmmm-------
---------------m#####-------------m----------------m###------#-------m####-----m---------mm-mm-------[]-m---------m######------m--------mm-#-m------------------m####--############################-m------
--------------m######--------------m--------------m####------#-m--mmm#####------m--------m--[]-------pP--m----m--m#######-------m-------m--#--m-------mm-m-----m#####--############################--m-----
--mmmmmmmmmmmm#######---------------mmmmmmmmmmmmmm#####------##-mm########-------mmmmmmmm---pP-------pP---mmmm-mm########--------mmmmmmm---##--mmmmmmm#-m-mmmmm######--############################---mmmmm
################################################################-#########--------#-#-#-#---pP-------pP----#-#--#########--------#-#-#-#---##---###########################################################
