-----------------------------------------------------------------------------------------------------------------------------------------------------------------------------------------------------------
-----------------------------------------------------------------------------------------------------------------------------------------------------------------------------------------------------------
-----------------------------------------------------------------------------------------------------------------------------------------------------------------------------------------------------------
-----------------------------------------------------------------------------------------------------------------------------------------------------------------------------------------------------------
-----------------------------------------------------------------------------------------------------------------------------------------------------------------------------------------------------------
-----------------------------------------------------------------------------------------------------------------------------------------------------------------------------------------------------------
-----------------------------------------M-------------------------M--------------------------------------------------------------------------------------------------------------M------------------------
--------------------------------------------------------------------------------------------------------------------------------------------------------------M--------------------------------------------
-------------------------------------------------------------------------------------------------------------------------------------------------------------------------------m---------------------------
---------BBBBB---------------------------mm------------------------mm--------------------------------------------------------------------mm-------------------------------------mmmmmmmmmmmmmmmmmmmmmmmmmmm
---------------------------------mm-----m#-m--------m-------K-----m#-m------m---------------mmmm-----------mm-------------mmm-----------m#-m-----------------mmmmmmmmmmmmmmmmmmm###########################
---------------------mm----mm---m#-m----m#--m-----mm-mm-----------m#--m---mm-mm------mmm---m[]#-m---------m#-m----mmm------#-m---K------m#--m-------mm-------K#############################################
--mmmmmmmmmmmmmmmmmmm#-mmmmk-mmmm#--mmmmm#---mmmmmgg-g-mmmmmmmmmmmm#---mmmgg-g-mmmmmmgg-mmmmpP#--mmmmmmmmmm#--mmmmkg-mmmmmm#--mmmmmmmmmmm#---mmmmmmmk-mmmmmmmm###################-#########################
###########################################################################################################################################################################################################
