------------------------------------------#################################################################################################################---------pP------------------------------------#
--------------------------------------------------------------------------------------------------------------------------------------------------------------#############################################
-----------------------------------------------------------------------------------------------------------------------------------------------------------------------------------------------------------
-----------------------------------------------------------------------------------------------------------------------------------------------------------------------------------------------------------
------------------------------------------------------------------m----------------------------------------------------------------------------------------------------------------------------------------
--------------------------------------BBBBB--------------------mmm-m--------------------------------------------------------------------------mm---oom-----------------------------------------------------
-------------------------------------B------------------------m###--m------------------------------------------------------------------------mm-mmmmm-m----------------------------------------------------
---------------------------------mm-----mm-------------------m####---m----------------------------------------------------------------------mm------M--m---------------------------------------------------
---------------------------------m-m---mm-m-----------------m#####----m---------------------------------------------------------------------m-----------m--------------------------------------------------
-------------------------------mm---mmmm---mm--------------m######-----m------------------------------------------------------------------mm-------------m-------------------------------------------------
-----------------------mmm----m[]----[]----[]m------------m#######------m---------------------------m------------------------------------m##--------------mmm-------mmmm-----------------------------------
--------------mm------m[]-m---mpP----pP----pP-m----mmmmmmm########-------m-------------------------mmmmm--------------------------------m###--------------[]-m-----mm[]-m----------------------------------
--mmmmmmmmmmmmg-mmmmmmmc---mmmmpP----pP----pP--mmmm###############--------mmmmmmmmmmmmmmmmmmmmmmmmm#-[]-mmmmmmmmmmmmmmmmmmmmmmmmmmmmmmmm####--------------pP--mmmmmm-pP--mmmmmmmmmmmmmmmmmmmmmmmmmmmmmmmmmm
############################################ ---#-################--------#-#-#-#-#-#-#-#-#-#-#-#-#--pP--#-#-#-#-#-#-#-#-#-#-#-#-#-#-#-#####--------------pP---##-#--pP---##-#-##-#-#-#-#-#-#-#-#-#-#-#-#-#
