-----------------------------------------------------------------------------------------------------------------------------------------------------------------------------------------------------------
-----------------------------------------------------------------------------------------------------------------------------------------------------------------------------------------------------------
-----------------------------------------------------------------------------------------------------------------------------------------------------------------------------------------------------------
-----------------------------------------------------------------------------------------------------------------------------------------------------------------------------------------------------------
-----------------------------------------------------------------------------------------------------------------------------------------------------------------------------------------------------------
----------------------------------------------------------------------M------------------------------------------------------------------------------------------------------------------------------------
-----------------------------------M-----------------------------------------------------------------------------------------------------------------------------------------------------------------------
---------------------------------------------------------------------------------------------------------------------mm------------------------------------------------------------------------------------
------------------------------------m---------------------------------mm-----------------------mmm-------mmm--------mm-mmmmm-------------------------------------------------------------------------------
-----------------------------------m-m------------------------mmm----m#-m---------------------m[]-m-----m[]-m------mm----[]-m--------------------------------mmmmmmmmmmmmmmmmmmmmmmmmmmmmmmmmmmmmmmmmmmmmmm
--------------------------mmm-----m#--m------mmm-----mmm-------#-m---m#--m---mm----mmm---mmm--mpP--m----mpP--m-----mC----pP--m------mm----mmm---mm----------m[]############################################
--------------------------mC-m-KK-m#---mmmmmmgg-mmmmmgg-mmmmmmmC--mmmm#---mmmg-mmmmgg-mmmkk-mmmpP---mmmmmC ---mmmmm-c----pP---mmmmmmg-mmmmgg-mmmg-mmmmmmmmmmmpP############################################
--mmmmmmmmmmmmmmmmmmmmmmmm-c--mmmmmC#######################################################################################################################################################################
####################################---------------------------------------------------------------------------------------------------------------------------############################################
