-------------------------------------------------------#########################-----------------------------------------------------------------##########################################################
-----------------------------------------------------------------------------------------------------------------------------------------------------------------------------------------------------------
--------------------------------------------------------------------------------------------------------------m--------------------------------------------------------------------------------------------
----------------------------------------------------------------------------------#------------------------mmm-m-------------------------------------------------------------------------------------------
----------------------------------------------------------------------------------#-----------------------m###--m-----------------------------------------------------------------------------m------------
-----------------------------------------------------------------------------------#---------------------m####---m--------------------------B-------------------m---------------------------mm-m-----------
--------------------------------------------------------------------------------------------------------m#####----m--------------------------------------------m-m-------------------------m##--m----------
----------------------------------------------------#--------------------------------------------------m######-----m-----------------------m-mmm--------------m#--m-----------------------m###---m---------
--------------------------------mm------------------#-------------------------------------------------m#######------m----------------------mmmmmm------------m##---m---------------------m####----m--------
-------------------------------mC-m---??????---BBBBB##---------------mmmmmmmmmmmmmmm-----------------m########-------m-------------------mm-?----mmm--------m###----m-------------------m#####-----m-------
------------------------mmm----mC--m---------K-K-----mmm------------m##############-m------mm-m-----m#########--------mm-m---------------m#---------m------m####-----m-----------------m######------m------
------------------------mC-m---mC---m----------------m#-m----mmmmm--m############--#-mmmmmm#-m-mmmmm##########--------#-m-mmmmmmmmmmmmmmm-#----#-----m----m#####------m----m----------m#######-------m-----
--mmmmmmmmmmmmmmmmmmmmmm-c--mmmmC----mmmmmmmmmmmmmmmmm#--mmmm####-mm#############---#########################################################---------mmmm######-------mmmm-mmmmmmmmmm########--------mmmmm
########################################################--#-#-#-#--##############----------------------------------------------------------------------#-#######--------#-#--#-#-#-#-#########--------#-#-#
