---------------------------------------------------------------------------------------------------------------------------#########################################-----#########-----------------##------
--------------------------------------------------------------------------------------------------------------------------------------------------------------------#---##########-----------------##------
---------------------------------------------------------------------------------------------m-----------------------------------------------------------------------#--##########-----------------##------
----------------------------------------------------------------------------------------------m---------------------------------------mm------------------------------############-----------------##------
-------------------------------------------------------------------------------------------mm--m-------------------------------------mm-mmm----------------------------#################-----------##------
------------------------------------------------------------------------------------------m##---m-----------------------------------mm-----m-----------------------mm------------------------------##------
-----------------------------------------------------mm--------------V-------------------m###----m---------------------------------mm-----------------------------mm-m---------------------##------##-#####
----------------------------------------------------mm-mm------------[]---------------mmm####-----m--------------------------------m--------m--------------------mm---m---------------------##########-----
----------------------------------------------------m----mmm---------pP----------------g#####------m---------mm-m-----------------m----------mmm-----------------m-----m--------mm-m-----------------------
-----------------------mmm------------mmm---------mm-----[]-m-------????------??B-----m######-------m-------mmVm-m---------------m#---------###-m--------mmmmmmmm-------mm-----mmgm-m-----mm----------m----
----------------------m[]-m------K----m?-m--K----m[]-----pP--m-----------------------m#######--------m-----mm-[]--m----mmmm-----m##------#######-m------m########---------m---m####--m---mm-m----------m---
-----------------mm---mpP--m----------m---m------mpP-----pP---m----mmm-------mmm----m########---------mm-m-m--pP---m---m[]-m---m###------######---m----m#########------------m#####---m--m---mm--m--mm--m--
--mmmmmmmmmmmmmmmg-mmmmpP---mmmmmmmmmm-----mmmmmmmpP-----pP----mmmmgg-mmmmmmmgg-mmmm#########---------#-m-m---pP----mmm-pP--mmm####-----#######----mmmm##########----------mm######----mm------mm-mmk#---mm
###########################################################################################################################-#-#####----########-----#-###########---g-------#######-----#-------#--###----#
