------------------------------------------------###-#------------------------------------------------------------------------------------------------------------------------------------------------------
--------------------------------------------------#####----------------------------------------------------------------------------------------------------------------------------------------------------
-----------------------------------------------------------------------------------------------------------------------------------------------------------------------------------------------------------
-----------------------------------------------------------------------------------------------------------------------------------------------------------------------------------------------------------
-----------------------------------------------------------------------------------------------------------------------------------------------------------------------------------------------------------
------------------------------------------------------------------------------------------------------B----------------------------------------------------------M----------------------------------------M
--------------------------------------------------------------------*--------------------------------------------------------------------------------------------------------------------------------------
-----------------------------------------------------------------------------------------------------------------------------------------------------------------------------------------------------------
----------------------------mm-------------------------------------m------------------------------mm-------------------------------------------------------------mm---------------------------------------m
-------------------mmm------m-mmmm--O-----------?------------------mm-------?M????---------------mm-mmm---------------------------------------------------------m#-m-------------------------------------m#
------------------m[]-m---mm---[]-m------------------O-----------mm-?m----------------------K---mm----#m----mm----mmm---------------mm----------mm--------------m#--m------mmm-----mm---------mm---------m#
-------------mm---mpP--m--mC---pP--m-----------mmm---------------m#---m--------------------------C----#-mmmmk-mmmmkk-mmmmmmmmmmmmmmmk-mmmmmmmmmmk-mmmmmmmmmmmmmmm#---mmmmmmgg-mmmmmk-mmmmmmmmmk-mmmmmmmmmm#
--mmmmmmmmmmmk-mmmmpP---mm-c---pP---mmmmmmmmmmmgg-mmmmmmmmmmmmmmm-#-k--mmmmmmmmmmmmmmmmmmmmmmmmmmc----#####################################################################################################
##################################################g-##-#############################################-------------------------------------------------------------------------------------------------------
