----------------------------------------------------------------------------------------------------------------------------------------------------------------------#####################################
----------------------------------------------------------------------------------------------------------------------------------------------------------------------#####################################
----------------------------------------------------------------------------------------------------------------------------------------------------------------------#####################################
----------------------------------------------------------------------------------------------------------------------------------------------------------------------#####################################
---------------------------------------------------------------------------------------------------------------------------------------------------------------------######################################
---------------------------------------------------------------------------------------------------------------------------------------------------------------------######################################
-------------------------------------------------------------------------M-------------------------------------------------------------------------------------------######################################
--------------------------------------------------------------------------------------------------------------------------------------------------------------------#######################################
-------------------------------------------------------------------------------------------------------------------------------------------------------------------m#######################################
--------------------------------------------------mm---------------------mm-----------------------------------------------------------------------------------------#--####################################
--------------------------------m----------------mm-m----mm-------------m#-m------------mm---------mm----------m---------mmm---------------mm---------------------mmm--####################################
------------------------mm----mm-mm--------------m#--m--m#-m------------m#--m---mmm----m#-mm------mmmmm-m-----m-m---mm----#-m-----mm------m#-m---------------------#-mm------------------------------------
--mmmmmmmmmmmmmmmmmmmmmmg-mmmmgg-g-mmmmmmmmmmmmmm-#---mmm#--mmmmmmmmmmmmm#---mmmgg-mmmmm#-k-mmmmmmm--#-m-mmmmmg--mmmg-mmmm#--mmmmmk-mmmmmmm#--mmmmmmmmmmmmmmmmmmmmm#-##mmmmmmmmmmmmmmmmmmmmmmmmmmmmmmmmmmmm
######################################################################################################-#--#################################################################################################
