------------------------------------------------##---------------------------------------------------------------------------------------------------------------------------------------------------------
-----------------------------------------------------------------------------------------------------------------------------------------------------------------------------------------------------------
-----------------------------------------------------------------------------------------------------------------------------------------------------------------------------------------------------------
-----------------------------------------------------------------------------------------------------------------------------------------------------------------------------------------------------------
------------------------------------------------------------?----------------------------------------------------------------------------------------------------------------------------------------------
------------------------------------------------BB---------------------------------------------------------------------------------------------------------------------------------------------------------
-------------------------------------------------MB#---------#--------------------------M--------------------------------------------M---------------------------------------------------------------------
---------------------------------------------------#-------#-#---------------------------------------------------------------------------------------------------------------------------------------------
----------------------------------------------mmmmm##------###--------------------------------------mm-----------------------------------------------------------------------------------------------------
-----------------------------mm---------------m####--------KM##-------------------------mm---------mm#mm---???M?---------------------mm----------------------------------mm--------------------------------
----------------------------mC-m--------------m#-##m---------------------------mmm-----m#-m-------mm-#--m-------mmm-----------------m#-m--------------------------------m#-m-------K-----------K-----------
----------------------------mc--m-------------m#---#mmmmmmmmmmm------mm-m------m#-m----m#--m------m--#---m------K#-m-------mm----K--m#--m---mmm----------mmm------------m---m-------mmm---------mm-----K---
--mmmmmmmmmmmmmmmmmmmmmmmmmmm#---mmmmmmmmmmmmm-#----##########-mmmmmm#-m-mmmmmm-#--mmmmm#---mmmmmm---#----mmmmmmm#--mmmmmmmk-mmmmmmmm#---mmmgg-mmmmmmmmmmgg-mmmmmmmmmmmmm----mmmmmmmgg-mmmmmmmmmg-mmmmmmmmm
##################################################----------###############################################################################################################################################
