-----------------------------------------------------------------------------------------------------------------------------------------------------------------------------------------------------------
-----------------------------------------------------------------------------------------------------------------------------------------------------------------------------------------------------------
-----------------------------------------------------------------------------------------------------------------------------------------------------------------------------------------------------------
-----------------------------------------------------------------------------------------------------------------------------------------------------------------------------------------------------------
----------------------------------------------------------------------------------------------------------------------B-----------------------------------------------------------mm-----------------------
-----------------------------------------------------------------------------------------------------------------------B--------------m--mmm-------------------------------------mm-mmm--------------------
---------------------------------M-------------------------------------M-----------------------MB--------------------------------------mm#+-m-----------------------------------mm-----m-------------------
-----------------------------------------------------------------------------------------------K--------------------------------------m###---m--------------mmm-----------------m-------m------------------
----------------------------------------------------------------------------------------------------------------------mm-------------m####----m-------------mB-m--------------mm---------m-----------------
-----BBBB?B----------------------m-------------------------------------mm----------------------mm--------------------mm-m-----------m#####-----m--------Kmmm----m------------m[]----------m--------K--K----
--------------------------mmm---m#m-----------------------------------m#-m-------mm-----------m#-m---------m--------mmY--m------K--mm#####------mm-------m[]-----m-----------mpP-----------m---------------
---------------------------#-m--m#-m------------mmm-------mmm-----mm--m#--m-----m#-m----------m#--m-------m-mm------m-y---m--------m######------k-mmmmmmm-pP------mmmmmmmmmmmmpP--------C---mmmmmmmmmmmmmmm
--mmmmmmmmmmmmmmmmmmmmmmmmm#--mmm#--mmmmmmmmmmmmgg-mmmmmmmgk-mmmmmg-mmm#---mmmmmm#--mmmmmmmmmmm#---mmmmmmmg-k-mmmmmm--#----mmmmmmmm-#-#####################################################################
#######################################################################################################################----###########---------------------------------------------------------------------
