------------------------------------------------------------------------------------------------------------------------------------------###-------#-----------###########################################
------------------------------------------------------------------------------------------------------------------------------------------###-------##----------###########################################
------------------------------------------------------------------------------------------------------------------------------------------###-------###---------###########################################
------------------------------------------------------------------------------------------------------------------------------------------#############---------###########################################
----------------------------------------------------------------------------------------------------------------------------------------------------#####-------###########################################
----------------------------------------------------------------------------------------------------------------------------------------------------------------###########################################
---------------------------------------------------------------------------------M------------------------------------------------------------------------------###########################################
---------------------------------------------------------------------------------M--------------------------------------------------------------------------##--###########################################
---------------------------------------------------------------------M--------------------------mmm----------------------------------------------------------##############################################
---------------?-------?------------------------------------mmm------------------mm------------mm[]mm-----------------------------------mmm-----------------------#########################################
-----------------------------------------------------------m[]-m--------mmm-----m#-m----------mm-pP--m------------??M----------------mmmmmmmmm---mm--------mm------########################################
-----------------------------------------mm----------mm----mpP--m---mmm-mC-m----m#--m---------m--pP---m------mm----------mmmmm--------[]---###m--m-mmm----mm-m---m-----------------------------------------
--mmmmmmmmmmmmmmmmmmmmmmmmmmmmmmmmmmmmmmmk-mmmmmmmmmmk-mmmmmpP---mmmm#-m-c--mmmmm#---mmmmmmmmm---pP----mmmmmmg-mmmmmmmmmmgggg-mmmmmmmmpP---###-mm-----mmmmm---mmm-mmmmmmmmmmmmmmmmmmmmmmmmmmmmmmmmmmmmmmmmm
#########################################################################################################################################--###--#------#-#------###########################################
