-----------------------------------------------------------------------------------------------------------------------------------------------------------------------------------------------------------
-----------------------------------------------------------------------------------------------------------------------------------------------------------------------------------------------------------
-----------------------------------------------------------------------------------------------------------------------------------------------------------------------------------------------------------
-----------------------------------------------------------------------------------------------------------------------------------------------------------------------------------------------------------
-----------------------------------------------------------------------------------------------------------------------------------------------------------------------------------------------------------
-----------------------------------------------------------------------------------------------------------------------------------------------------------------------------------------------------------
-------------------------------------------------------------------------------------------?-------------------------------------M-------------------------------------------------------------------------
-----------------------------------------------------------------------------------------------------------------------------------------------------------------------------------------------------------
-----------------------------------------------------o-------------------------------------------------------------------------------------------------------------------------------------mmm-------------
----------------------------------------------------------------mmm------------------------mm------------------------------------mm--------------------------------------mmm--------------mm[]mm---??------
---------------------------------------------------------------m[]-m---------mmm---KK-----m#-m----------------------------------m#-m------------------------------------m[]-m------------mm-pP--m----???---
-------------------mmm---------mm--------------mm---mmm--------mpP--m---K----mC-m---------mc--m-------mm----mmm-----------mmm---m#--m---mm-mmm-----mm-------------------mpP--m----------Km--pP---m---------
--mmmmmmmmmmmmmmmmmgg-mmmmmmmmm#-mmmmmmmmmmmmmmk-mmmmC-mmmmmmmmmpP---mmmmmmmm-c--mmmmmmmmmm#---mmmmmmmg-mmmmgg-mmmmmmmmmmmgg-mmmm#---mmmk-mgg-mmmmmk-mmmmmmmmmmmmmmmmmmmmpP---mmmmmmmmmmm---pP----mmmmmmmmm
###########################################################################################################################################################################################################
