----------------------------------------------------------#################-----------------------------------------------------##########################-----------####----------pP---------pP--------#-#
------------------------------------------------------------------------------------------------------------------------------------------------------------###############################################
---------------------------------------------------------------------------m------------------------------------------------mm-----------------------------------------------------------------------------
----------------------------------------------------------------------------m----------------------------------------------mm-m----------------------------------------------------------------------------
--------------------------------------------------------------------------m--m--------------------------------------------mm---m---------------------------------------------------------------------------
------------------------------BBBBBB------------------mm-----------------mm---m-------------------------------------------m-----m--------------------------------------------------------------------------
-----------------------------------------------------mm-mm--------------m##----m--------------------------------------mm-m-------m------------------------------------------mm-----------------------------
----------------------------------------------------mm----m-O----------m###-----m---------------------------------------m#--------m----------------------------------------mm-mmm-------mm-o---------------
----------------------------------------------------m------m----------m####------m------------------------------------mg##--------------------------------mm--------------mm-----m-----mm-mmm--------------
-----------------------?----mm--BBBBBB----mmm-----mm-----------------m#####-------m-----------------------------------m###---------mm--------------------m#-m-------------m-------m---mm-----m-------------
----------------------------m#m---------m-mm#m---m[]------Y-mm------m######--------m------------------------K--------m####--------##-m------------------m##B-m---------mmm---------m--m-------m------------
-------------mm------mm----mC#-m-------K-m--#-m--mpP------y-#-m----m#######---------mm-m-----mm---------------------m#####--------##--m----------m-----m###---m-------m###----------mm---------mmm---------
--mmmmmmmmmmmk-mmmmmmg-mmmmmc#--mmmmmmmmm#--#--mmmpP------g-#--mmmm########---------#-m-mmmmmg-mmmmmmmmmmmmmmmmmmmmm######-------###---mmmmmmmmmm-mmmmm####----mmmmmmm####----------[]---------[]-mmmmmmmmm
###########################################-###############-#---#-#########-########################################################----#-#-#-#-#-k-#-#####-----##-#-#####----------pP---------pP--#-#-####
