-------------------------------------------------------------------------------------------------------######-######-------------###########--#--------------------#-----------------#---------------------
------------------------------------------------------------------------------------------------------------#########------------------------############################################------------------
---------------------------------------------------------------------------------------------------------------------##------------------------------------------------------------------------------------
----------------------------------------------------------------------------------------------------------------------##-----------------------------------------------------------------------------------
-----------------------------------------------------------------------------------------------------------------------------------------------------------------------------------------------------------
-----------------------------------------------------------------------------------------------------------------------------------------------------------------------------------------------------------
---------------------------------------------------------------------B-------------------------------------------------------------------------------------------------------------------------------------
-----------------------------------------------------------------------------------------------------M----------------------------------------------------------------------------------------#------------
------------------------------------------------------------------------------------------------------m---------------?-----------------------mmmm---------------------------------------------------------
-------------------------------------mm------------------------------mm-------------------------------mm---------------BBB-#-----------------mm#--m--------------------------------------------------------
----------------------------mmm-----mC-m-----mm------K--------------m#-m----------------------------mm--m--------mmmmm---B--mm---------------m?#---m----------------------------------------mmm------------
----------------------------mC-m-K--mc--m---m#-m------------K-------m#--m-----mmm--------------------#----------m#####m-----m-m------------mm--#----m----------------------m----------mm----m#-mmmmmmmmmmmm
--mmmmmmmmmmmmmmmmmmmmmmmmmm-c--mmmmmC---mmmm#--mmmmmmmmmmmmmmmmmmmmm#---mmmmmgg-mmmmmmmmmmmmmmmmmmmm#--#mmmmmmm#####-?mmmmm---mmm-mmmmmmmm##--#-----mmmmmmmmmmmmmmmmmmmmmm-mmmmmmmmmm#-mmmm---############
#######################################################################################################-#-##-########---#-##---##-#-#-#-#-#-#--#------##-#-#-#-#-##-#-#-#-#--#-#-#-#-##--#-#---------------
