---------------------------------------------------------------------->#######################################################-----#####---#####---------##------------------------------------------------
-----------------------------------------------------------------------------------------------------------------------------###################---------##------------------------------------------------
------------------------------------------------------------------------------------------------------------------------------------------############--###------------------------------------------------
--------------------------------------------------------------------------------------------------------------------------------------------------------###------------------------------------------------
-----------------------------mmmm-------------------------------------------------------------------m---------------------------------------------------###-------------------------------------m----#-----
----------------------------m###-m----------------------------------------------------------------mm-m---------------------------------------------------##------------------------------------m-m---------
---------------------------m####?-m---------------------------------BB---------------------------m##--m--------------------------------------------------------------------------------------mm#--m--------
--------------------------m#####---m------------------------------------------------------------m###?--m--------------------------------mm--------------------------------------------------mg##---m-------
-------------------------m######----m------------------------------?-----------mm--------------m####----m------------------------------m#-m-------------------------------------------------m###----m------
-----B*B?BB??M??--------m#######-----m----------------------------mm---?-----mm#-m------------m#####-----m----------------------------m##--mm---mm------------------------------------K----m####-----m----m
---------------------K-m########------m---------------------------m-m---------##--m?---------m######------m--------------------------m###----m-m#-m-------------------m--------mm---------m#####------mmmmk
----------------------m#########-------mm-m-----------------------m--m-------m##---m--------m#######-------m--------m-----m----m----m####-----m##--m--mm--------m---mm-mmmmmmmmk-mmmmmmmmm######------#####
--mmmmmmmmmmmmmmmmmmmm##########-------#-m-mmmmmmmmmmmmmmmmmmmmmmm----mmmmmmm###----mmmmmmmm########--------mmmmmmmm-mmmmm-mmmm-mmmm#####-----###---mm#-mmmmmmmm-mmm-#-#########################-----------
##################################################################-----##-#-####-----#-#-#-#########---------#-#-#-#---#-#--#-#--#-######----####----#---###-#-#-#-#---------------------------------------
