-----------------------------------------------------------------------#-----#######################################################--#####################################################################
------------------------------------------------------------------------------------------------------------------------------------#-#####################################################################
-------------------------------------------------------------------------------------------------------------------------------------######################################################################
--------------------------------------------------------------------------------------------------------------------------------------#####################################################################
-----------------------------------------------------------------------------------------m---------------------------------------------####################################################################
-----------------------------------------------------------------------B---------------mm-m---------------------------------------------###################################################################
----------------------------------------------------------------------M-?m------------m##--m---------------------------------------------##################################################################
-------------------------------------------------------------------------#-----------m###---m---------------------------------------------#################################################################
-----------------------------------------------------------------------m-?m---------m####----m----------------------------------------mmm--################################################################
-------?M?-------------mm---?????????----------mmm--------------------m#m----------m#####-----m--------------------------------mmmmmmmmm---##################pP############################################
------------mmm---mm--mC-m-------K----Kmmm----m[]-m------------------m#-#--m------m######------m------------------------------m######?-##mm-###############################################################
------------mC-m-mC-m-mc--m-------------C-m---mpP--m------mmm--------m#--m--m----m#######-------m-------------------------m--m######---####m---------------------------------------------------------------
--mmmmmmmmmm-c--mmc--mmC---mmmmmmmmmmmmm#--mmmmpP---mmmmmmgg-mmmmmmmmm#--##--mmmm########--------mmmmmmmmmmmmmmmmmmmmmmmmm-mm#######---#####mmmmmmmmmmmmmmmmmmmmmmmmmmmmmmmmmmmmmmmmmmmmmmmmmmmmmmmmmmmmmmm
########################################################################------#-#########--------#-#-#-#-#-#-#-#-#-#-#-#-#--########---####################################################################
