------------------------------------#----------------------------------------------------------------------------------------------------------------------------------------------------------------------
-----------------------------------------------------------------------------------------------------------------------------------------------------------------------------------------------------------
-----------------------------------------------------------------------------------------------------------------------------------------------------------------------------------------------------------
---------------------------------------------------------------------------------------------------------------------------------B-------------B-------------------------------------------------?---------
-----------------------------------------------------------------------------------------------------------------------------------------------------------------------------------------------------------
-----------------------------------------------------------------------------------------------------------------------------------------------------------------------------------------------------------
---------------------------------------------------------------------mmm----------------------------------mm-----------------------BBBBBBBB----mm------------------------------------mm----------mm--------
--------------------------------------------------------------------m[]-m---------K---mmm--Kmmm--K---K---mC-m-----------K--mmm--Kmm-----------m#-m----------------------------------mm#m--------m#-m-------
----------------------------------mmmm----------------------mm------mpP--m------------mC-m--mC-m---------mc--m----------K---C-m-m#------------m#--m---------------mm------------------#-m--mm---m#--m------
---------------------------------m####mmmmmmmmmmmmmmmmmmmmmm#-mmmmmmmpP---mmmmmmmmmmmm-c--mm-c--mmmmmmmmmmc---mmmmmmmmmmmmmmc--mm#-mmmmmmmmmmmm#---mmmmmmmmmmmmmmmk-mmmmmmmmmmmmmmmmm-#--mmk-mmmm#---mmmmmm
--------------------------------m###-######################################################################################################################################################################
-------------------------------m####-----------------------------------------------------------------------------------------------------------------------------------------------------------------------
--mmmmmmmmmmmmmmmmmmmmmmmmmmmmm#####-----------------------------------------------------------------------------------------------------------------------------------------------------------------------
#####################################----------------------------------------------------------------------------------------------------------------------------------------------------------------------
