-----------------------------------------------------------------------------------------------------------------------------------------------------------------------------------------------------------
-----------------------------------------------------------------------------------------------------------------------------------------------------------------------------------------------------------
-----------------------------------------------------------------------------------------------------------------------------------------------------------------------------------------------------------
-----------------------------------------------------------------------------------------------------------------------------------------------------------------------------------------------------------
-----------------------------------------------------------------------------------------------------------------------------------------------------------------------------------------------------------
-----------------------------------------------------------------------------------------------------------------------------------------------------------------------------------------------------------
-----------------------------------------------------------------------------------------------------------------------------------------------------------------------------------------------------------
------------------------------------------------------------------------------------------------------------------------------------------------------------------mm--------------------------m------------
---------------------------------------------------------m-------------------------------mm----------------------------------------------------------------------mm-m------------------------m-------------
------------BBBB--------------------mm--------------?---m-m-----------mm----BBBB--------mm-mmm---------------------------------------------mmm-------------------m---m-----------------------m#mB----------
-------------------Kmmm---Kmmm-----mC-m----KK---K---K--mC--m----K-K--mC-m--K---Kmm----Kmm-----m----------------------------------mmm------m[]-m----------------Kmm----mm----------mmmm-------m#-m----------
--------------------mC-m---mC-m----mc--m-------K-------mc---m--------mC--m-----mC-m----mC-----#m------mm----mm--------------------#-m-----mpP--m--------mmm-----mC----C-m----------[]-m-----m##--m-----mmm-
--mmmmmmmmmmmmmmmmmm-c--mmm-c--mmmmmc---mmmmmmmmmmmmmmmmc----mmmmmmmmmc---mmmmmmc--mmmm-C-----#-mmmmmmk-mmmmk-mmmmmmmmmmmmmmmmmmmm#--mmmmmmpP---mmmmmmmmgg-mmmmm-c----c--mmmmmmmmmmpP--mmmmmm##---mmmmmgg-m
################################################################################################-##########################################################################################################
