---------------------------------#-####--##-------#------#---###---###------------------------------#--------------#---------###-------o---------------------------#--######-------------------------------
---------------------------------######--##################--###----##--------------------------####################################################################--######------------------------------m
--------------------------------------------------------------##----###-----------------------------------------------------------------------------------------------#################--------------------
-------------------------------------------------------------######-##----------------------------------------------------------------------------------------------------------------------------------mm-
------------------------mm--#--------------------------------------###-###---[]------------------------------------------------------------------------------------------------------------------------m##-
-----------------------mg-m-----------------------------------------##-------pP----------------------------------------------------------------------------------------------------------------------mm###-
----------------------m##--m-------------mm-m------------------------##------pP---------------------------------------------------------------------------------------------------------------------mg####-
---------------------m###---m-----------mm-m-m-------------------m-----------pP---------------------------------------------------------------------------------------------------------------------m#####-
--------------------m####?---m----------m-##--m--------------mm-m------------###------------------------------------------------------------+------------------------------------------------------m######-
-------------------m#####-----m--------m--##---m-----------mmm-m#?--------------------------mm----------------------------------mmmmmmmmmm--------------------------------------------------------m#######-
------------------m######------m------m#--##----m----------m?-###----------mm---------mm---mm-m--------------------------------m#BBBBBBBB-m--------------------------mmm----mmm---------mm-m-----m########-
-----------------m#######-------m----m##--##-----m--------m---###------mm--m-m--------m-m--m---m--------------------mm--------m##----------m-------------------------m?-m--m#B-m--mmm--m#-m-mmmmm#########-
--mmmmmmmmmmmmmmm########--------mmmm###--##------mmmmmmmm#---###?--mmm?-mm---mmmmmmmm---mm-----mmmmmmmmmmmmmmmmmmmm#-mmmmmmmm###-----------mmmmmmmmmmmmmmmmmmmmmmmmm--k-mm##---mm??-mm####################
#########################---------######--##-------#-#-#-##---###---###---#----#-#-#-#----#------##-##-#-#-#-#-#-#-##--#-#-#-####-----------##-#-#-#-#-#-#-#-#-#-#-##--#--###----#----#--------------------
