-----------------------------------------------------------------------------------------------------------------------------------------------------------------------------------------------------------
-----------------------------------------------------------------------------------------------------------------------------------------------------------------------------------------------------------
-----------------------------------------------------------------------------------------------------------------------------------------------------------------------------------------------------------
-----------------------------------------------------------------------------------------------------------------------------------------------------------------------------------------------------------
-----------------------------------------------------------------------------------------------------------------------------------------------------BBB?????BB???-----------------------------------------
------------------------------------------------------------------------------------------M-------------------------------------B--------------------------------------------------------------------------
-----------------------------------------------------------------M-mm--------------------------------------------------------------------------------------------------------------------------------------
------------------------------------------------------------------mm-m-----------------------------------------------------------------------mmm---------------g-------------------------------------------
------------------------------------------------------------------m-#-mm------------------mm------------------------------------m-----------mm[]mm-----???????M????---------------------------------mmm----
-----------------------------------------------------------------m--##--m----------------m#-m-------------------mmm------------m#m---------mm-pP--m------------------------------------------------m[]-m---
---------------------------------------------------------mmm----m#--###--m-------mm------m#--m-----mm------------#-m-----------m#-m----mmm-m--pP---m-----mm----------------mm-------------mmm------mpP--m--
----------------------------mm---------------------------mC-m-K-m#--###---mmmmmmmk-mmmmmmm#---mmmmmg-mmmmmmmmmmmm#--mmmmmmmmmmmm#--mmmmgg-m---pP----mmmmmk-mmmmmmmmmmmmmmmmk-mmmmmmmmmmmmmgg-mmmmmmmpP---mm
--mmmmmmmmmmmmmmmmmmmmmmmmmmg-mmmmmmmmmmmmmmmmmmmmmmmmmmm-c--mmmmC--#######################################################################################################################################
##################################################################-----------------------------------------------------------------------------------------------------------------------------------------
