-----------------------------------------------------------------------------------------------------------------------------------------------------------------------------------------------------------
-----------------------------------------------------------------------------------------------------------------------------------------------------------------------------------------------------------
-----------------------------------------------------------------------------------------------------------------------------------------------------------------------------------------------------------
--------------------------------------------------------------------------------------------------------------------------------------------------pP-------------------------------------------------------
-----------------------------------------------------------mmm------------------------------------------------------------------------------------[]-------------------------------------------------------
----------------------------------------------------------m##-m----------------------------------------?B??????---------------------BBBBB??-----B-[]----------------------------------------------------m-m
--------------------------------------------------------mm###--m--------------------------------------------------------------------------------mmmmm--------------------------------------------------m-m#
---------------------------------------------------------####---m------------------------------------------------------------------m------------m#---m-------------------------------------------------m###
--------------------------------------------------------m####----m----------------------------mmm-------------------------------mmm-m--------mmm------m------------------------------------------------m###
-------------------------------------------------------m#####-----m---------??---------------mm[]mm--????M??-??----------------mm[]---B-----mm[]-------m----------------------------------------------m####
-------------------------------mmm-------mm-------mmmmm######------m------------------------mm-pP--m--?------------------------m-pP--m------m-pP--------m----mmm-------------------------------------m#####
-----------------mm-------------#-m-----m#-m-----m###########-------mm-m------mmm-----------m--pP---m------------mm----------mm--pP--------m--pP---------mmmmgg-mmmmmmmmmmmmmmmmmmmmmmmmmmmmmmmmmmmmm######
--mmmmmmmmmmmmmmmk-mmmmmmmmmmmmm#--mmmmmm#--mmmmmm--#########-------#-m-mmmmmmgg-mmmmmmmmmmm---pP----mmmmmmmmmmmmg-mmmmmmmmmmkk--pP---mmmmmg--pP------#####################################################
################################################################################################################################################-----------------------------------------------------------
