--------------------------------------------------------------#######################----------------------------------------------------------------------------------------------------------------------
-----------------------------------------------------------------------------------------------------------------------------------------------------------------------------------------------------------
-----------------------------------------------------------------------------------------------------------------------------------------------------------------------------------------------------------
-----------------------------------------------------------------------------------------------------------------------------------------------------------------------------------------------------------
-----------------------------------------------------------------------------------------------------------------------------------------------------------------------------------------------------------
-----------------------------------------------------------------------------------------------------------------------------------------------------------------------------------------------------------
-------------------------------------------------------------------------BB-------------------------------------------------------------------------B------------------------------------------------------
-----------------------------------------------------------------------------------------------------------------------------------------------------------------------------------------------------------
------------------------------------------------------mm---------------------------------------------------------------------------------------------------------------------------------------------------
-------------------------------??---mm---------------mm-mmm-------------mm--------------------------------------------------------------------------mm-----------------------------------------------------
------------------------mmm--------mC-m-------K--K--mm-----m-----------mm#m-----------------------------------------------------------mmm----------m#-m----------------------m---------------------------mm
------------------------mC-m-------mc--m-------------C------m--mm------m-#-m--------mmm------mm----mm--------------------mmm-----------#-m---------m#--m-mmm-------mm------mm-mm----------mm------------m#-
--mmmmmmmmmmmmmmmmmmmmmm-c--mmmmmmmmc---mmmmmmmmmmmmmc-------mmm-mmmmmm--#--mmmmmmmm##-mmmmmmk-mmmmk-mmmmmmmmmmmmmmmmmmmmgg-mmmmmmmmmmm#--mmmmmmmmmm#---mgg-mmmmmmmk-mmmmmmkg-g-mmmmmmmmmmk-mmmmmmmmmmmmm#-
########################################################------#---#-#-#--#---#-#-#-#-#--###################################################################################################################
