--------------------------------###-------pP-------------------------[]----##############################################----------------------------------------------------------------------------------
--------------------------------####------pP-------------------------pP-------------------------------------------------#----------------------------------------------------------------------------------
------------------------------------###############################--pP------------------------------------------------------------------------------------------------------------------------------------
------------------------------------------------------------------######-----------------------------------------------------------------------------------------------------------------------------------
--------------------------------------------------------------------------------------------------m--------------------------------------------------------------------------------------------------------
---------------------------------------------------------------------------------------------mmmmm-m-------------------------------------------------------------------------------------------------------
--------------------------------------------------------------------------------------------m#####--m---------------------------V--------------------------m-m---------------------------------------------
-------------------------------m----------------------------------h------------------------m######---m--------------------BB----[]------------------------m-m-m--------------------------------------------
----------------------mmmmmmmmmmm------------BBBBBBBB?-BBBBBBBBBBBBB----------------------m#######----m-------------------------pP-------mm---------------mg#--m-------------------------------------------
---------------------m#########--------mm---------------------------B-------#----------mmm########-----m------------------------##-------m-m-------------m###---m-------------???--------------------------
--------------------m##########--m-----m-mmm------------------------------------------m###########------m---------------mmmmm---------mmm---mmm---------m####----m-----mmmm--------------------------------
-------------------m###########--#m---m----Vmm--mm--mmmm--mmmmmmmmmmm----m--------m--m############-------m-------m-----mm#??-m----m---m[]------m-------m#####-----mm-m-m[]-m------mm------------mmm--------
--mmmmmmmmmmmmmmmmm############--##mmmO----[]-mmB-mm????mm??????????-mmmmmmmmmmmmm-mm#############--------mmmmmmm-mmmmm#-#----mmmm-mmm-pP-------mmmmmmm######-----#-m-m-pP--mmmmmmg-mmmmmmmmmmmmgg-mmmmmmmm
###############################--###-#-----pP--#---#-----#------------###--#-#-#-#--##############--------#-#-#-#---#-#--#-----############------##########################################################
