-----------------------------------------------------------------------------------------------------------------------------------------------------------------------------------------------------------
-----------------------------------------------------------------------------------------------------------------------------------------------------------------------------------------------------------
-----------------------------------------------------------------------------------------------------------------------------------------------------------------------------------------------------------
-----------------------------------------------------------------------------------------------------------------------------------------------------------------------------------------------------------
-----------------------------------------------------------------------------------------------------------------------------------------------------------------------------------------------------------
-----------------------------------------BBB---------------------------------------------------------------------------------------------------------------------------------------------------------------
------------------------------------------------------------------M----------------------------------------------------------------------------------------------------------------------------------------
----------------------------------------------------------------------------------------------------------------------------------------------------------------------------------M------------------------
-----------------------------------------mm----------------------------------------------------------------------------------------------------------------------------------------mm----------------------
--------BB-------------mm-------????----mm-m----------------------mm--------------------------------------------------------mmm----------------------------------------------------m#m---------------------
--------------Kmmm----m?-m----------K--mm---m-----mmm------------m#-m--------------------------------------mmm-------------m[]-m------------mm----------------------------K------mm-#-m--------------m-----
---------------mC-m---m#--m-------------C----m-----#-m------K----m#--m---mm----mm-m----------mmm------------#-m----mm------mpP--m---mmm----m#-m-----mm-------mm-------------------#-#--m----mmm----mm-mm---
--mmmmmmmmmmmmm-c--mmmmC---mmmmmmmmmmmmmc-----mmmmm#--mmmmmmmmmmmm#---mmmg-mmmm#-m-mmmmmmmmmmgg-mmmmmmmmmmmm#--mmmmk-mmmmmmmpP---mmmgg-mmmmm#--mmmmmk-mmmmmmmk-mmmmmmmmmmmmmmmmmmm#-#---mmmmgk-mmmmgg-g-mmm
#####################################################################################################################################################################################-#####################
