-----------------------------------------------------------------------------------------------------------------------------------------------## ----??---------##########################################
------------------------------------------------------------------------------------------------------------------------------------------------##---------------##########################################
----------------------------------------------------------------------------------------------------------------------------------------------------------------###########################################
----------------------------------------------------------------------------------------------------------------------------------------------------##k---------###########################################
-----------------------------------------------------------------------------------------------------------------------------------------------------####------############################################
--------------------------------------------------------------------------------------------------------------------------------------------------------##########------###################################
-----------------------------------------------B-------------------------------B-------------------------------------------------*B---------------------------###--------##################################
-------------------------------------------------------------------------------------------------------------------------------------------------------------------------##################################
--------------------------------------------------------------------------------------------------------------------------------------------mm--------------------m----mm-#################################
----------------?????---------------------BBB--mm------------------------------mm------------------------------------------------mm--------mm-mmm------------mm--m-m--m##m-################################
-------------------------------K-----mmmm-----m#-m-------------mmm------------m#-m-------------------mmm------------------------mK-m------mm-----mm----------m-mm---mm####m-###############################
-------------------------------------m[]-m----m#--m------------m#-m----mm-----m#--m-----mmm-mmm-------#-m-mm--------------------m---m----KmC-----[]mmm----m---------g######m-------------------------------
--mmmmmmmmmmmmmmmmmmmmmmmmmmmmmmmmmmm-c---mmmmm#---mmmmmmmmmmmm-#--mmmmk-mmmmmm#---mmmmmgg-mgg-mmmmmmm#--mm#mmmmmmmmmmmmmmmmmmmmm----mmmmm-c-----pP---mmmm-mm------#########mmmmmmmmmmmmmmmmmmmmmmmmmmmmmmm
##############################################################################################################################################---pP----#-#--#------########################################
