-------------------------------------------#############----------------------------------------------------------------------------------------##-#-------#----##-------##################################
--------------------------------------------------------#----------------------------------------------------------------------------------------###------#############------------------------------------
---------------------------------------------------------------------------------------------------------------------------------------------------###-----------------------------------------------------
-----------------------------------------------------------------------------------------------------------------------------------------------------------------------------------------------------------
------------------------------------------------------------------------------------------------------------------------------------------+--------------------------------------------m-------------------
-----------------------------------------mm------------------------------------------------------------------------------------------------------------------------------------------mm-m------------------
----------------------------------------mm-m---------------------------------------------------------------------------mm-------------------mm--------------------------------------m##--m-----------------
----------------------------------------m---m-------------------------------------------------------------------------m#-m------------------m--------------------------------------m###---m----------------
-------------------------------------mmm-----m-------------?---???????--------BBBB------------------mmm--------------m##--m---???????-----mm-#m-----------------------------------m####----m---------------
------------------------------------m###------m----mmmmmm---------------mmmm-----------------------m[]-m------------m###---m-------------m[]-#-m----------------mmm--------------m#####-----m--------------
-----------------------------------m####----#--m--m######m--------------m[]-m-------------mm-------mpP--m----------m####----m------------mpP-##-m--------------mm##m----mm------m######------m-------------
----------------------------------m#####----##--mm######-#mmmmmmmmmmmmmm-pP--mmmmmmmmmmmmmh-mmmmmmmmpP---mmmmmmmmmm#####-----mmmmmmmmmmmmmpP-##--m-------m-----m-##-m---m-m----m#######-------m------------
--mmmmmmmmmmmmmmmmmmmmmmmmmmmmmmmm######----############--######################################################################################--mmmmmmm-mmmmm--##--mmm---mmmm########--------mmmmmmmmmmmm
########################################################----------------------------------------------------------------------------------------#--##-#-#--##-#--##---##----#-#########--------#-#-#-#-#-#-
