-------------------------------------####################--############################################---#####------#---------k###########--------#---##--------------------------------------------------
---------------------------------------------------------------##########################################################################################--------------------------------------------------
-------------------------------------------------------------------------------------------------------------------------------------------------------###-----------------------------------m-------------
----------------------------------------------------------------------------------------------------------------------------------------------------------------------------------mm-------mm-m------------
----------------------------------------------------------------------------------------------------------------------------------------------------------------------------------m-m-----m##--m-----------
----------------------------V---BBBB--------------------------------------------------------------------------------------------------------m------------------------------------m---m---m###---m----------
----------------------------[]------BBBO-------------------------------------------------------------------------------------------------mmm-m----------------------------------m#----m-m####----m---------
-----------------------mmm--pP----------------------------------------------------------------------------------------------------------m###--m--------------------------------m##-----m#####-----m--------
----------------------mm[]m-pP----mm--------------------m------------------------------------------------------------------------------m####---m------------------mm----------m###-----######------m-------
---------------------mm-pP-m-??BBmm-m------------------m------------------------------------------------------------------------------m#####----m-----------------m-m--------m####----#######-------m------
---------------------m--pP--m----m---m------mmmmmmmmmmmmCmm---------------------------------------------------mmm--------------------m######-----m-----mm------mmm---mm-----m#####----#######--------mm-m--
-----------mmm-----mm---pP------m-----m----m##############-m-----mmmmmmmmmmmmmmmmmmmmmmmmmmmmmmmmmmmmmmmm----m##-m------------------m#######------m----m-mmm---m[]-----mmmmm######---########--------#-m-mm
--mmmmmmmmmgg-mmmmmgg---pP---mmmk------mmmm###############--mmmmm#######################################-mmmm###--mmmmmmmmmmmmmmmmmm########-------mmmm-##+-mmm-pP-----####################################
##################################------#-################---##-########################################--######---#-##-#-#-#-#-############--------#-#-##---#######---------------------------------------
