------------------------------------------#####################################--###################################################################--------#-------------------#----#---------------------
------------------------------------------------------------------------------------------------------------------------------------------#################################-----###########################
-----------------------------------------------------------------------------------------------------------------------------------------------------------------------------------------------------------
-----------------------------------------------------------------------------------------------------------------------------------------------------------------------------------------------------------
-------------------------------------------------------------------------------------------------------------m---------------------------------------------------------------------------------------------
-------------------------------------------------------mmmm-----------------------mmm---------------------mmm-m--------------------------mm----------m-----------------------------------------------------
------------------------------------------------------m##?-m---------------------mmm-m-------------------m###--m------------------------mm-mmm---mmmm-m----------------------------------------------------
----------------------------------B------------------m###---m-------------------mm----m-----------------m####---m----------------------mm-----m-m####--m---------------------------------------------------
------------------------------------------m---------m####----m------------mm----m-V----m---------------m#####----m---------------------m-------m#####---m--------------------------------------------------
----------??BBB#--------------------------mm-------m#####?----m----------mm-mmmm--[]----m-------------m######-----m------------mmmmmmmm--------######----m------------------mm-----------------------------
--------------------K------------mmm-----m-?m-----m######------m--------mm----[]--pP-----m-----------m#######------m----------m########-------#######-----m----------------mm-mmm--------------------------
---------------------------------m#-m---m#---m---m#######-------m-------m-----pP--pP------mm--------m########-------m---m----m#########------########------m--------------mm-----m---------------m---------
--mmmmmmmmmmmmmmmmmmmmmmmmmmmmmmm-#--mmmm#-k--mmm########--------mmmmmmm------pP--pP-----[]-mmmmmmmm#########--------mmm-mmmm##########-----#########-------mmmmmmmmmmmmmmm------#mmmmmmmmmmmmmmm-mmmmmmmmm
############################################--#-#########--------#-#-#-#------pP--pP-----pP--#-#-#-##########--------#-#--#-###########-----#########--------#-#-#-#-#-#-#-------#-#-##-#-#-#-#-#--#-#-#-#-
