----------------------------------------------------------------------------------------------------------------------------------------------------------------------------#########----#-#----------#####
------------------------------------------------------------------------------------------------------------------------------------------------------------------------------------------#################
-----------------------------------------------------------------------------------------------------------------------------------------------------------------------------------------------------------
-----------------------------------------------------------------------------------------------------m-------------------------------------------------------------------------m---------------------------
--------------------------------------------------------------------------------------------------mmm-m--------------------------------------------------------------------mm-m-m--------------------------
-----------------------mmmmm-----------?-??B-----------------------------------------------------m###--m------------------------------------------------------------------mm-m---m-------------------------
----------------------m#BBB-m-----------?-------------------------------------------------------m####---m--------------------------------------------------------------m-mm-------m------------------------
---------------------m##-----m-----------------------------------------------------------------m#####----m------------------------------------------------------------m--m---------m-----------------------
-----------g--------m###------m---------------------------------------------------------------m######-----m--------------------------------------------mm-------------mgm-----------mmm---#----------------
--------BBB#-------m####-------m-----???-?---------------------------------------------------m#######------m------------------------------------------mm-mmm----------m##--------#####-m-------------------
---------------K--m#####--------m---K--------mmm---------------------mmm--------------------m########-------m----------mmm------K---K----------K--K--mm-----m------K-m###------#######--m-----------------m
-----------------m######---------m------------#-m-------mm------K-----#-mm-----------------m#########--------mm-m------mC-m---------------------------C------m------m####-----########---m---------------m#
--mmmmmmmmmmmmmmm#######----------mmmmmmmmmmmm#--mmmmmmmk-mmmmmmmmmmmm#-k-mmmmmmmmmmmmmmmmm##########--------#-m-mmmmmm-c--mmmmmmmmmmmmmmmmmmmmmmmmmmmc-------mmmmmm#####-----########----mmmmmmmmmmmmmmm##
#########################################################################################################################################################---##########################-----##-#-#-#-#-#####
