------------------------------------------------------------------------------------##---------------######----------#-------------------#--------#------------------------#-----?--###--------------------
-------------------------------------------------------------------------------------########################################-------------####################################--#---###------------####----
--------------------------------------------------------------------------------------------------------------------------------------------------------------------------------#---###--------------------
--------------------------------------------------------------------------------------------------------------------------------------------------------------------------------#---###--------------------
--------------------------------------------------------------------------------------------------------------------------------------------------------------------------------#---###--------------------
--------------------------------------------------------------------------------------------------------------------------------------------------------------------------------#--####--------------------
-------------------------------------------M--------------------------------------------------------------------------------------------mm--------------------------------------#--####--------------------
-----------------------------------M---------------------------------------------------------------------------------------------------m##m------------------------------------##--###########-------------
---------------------------m------------------------------------------mm+------mmmmm--------------------------------------------------m#-#-m------------------------------------#-###----------------------
--------------------------mmm--------------mm------------------------mm#m------m?##-m----------------------mmmm----------------------m##----m---------------------------------mm-#-#-----------------------
------------------------Kmm--m----mmm-----m#-m-----------------K-----m-#-m-----m-----m--------------------m#BB-m---------------mmmmmm#-#-----m-------------------------------m#-m--------------------------
-----------------mm------m-#--m---K#--m---m#--m-mmm------mm--------mm--#--m----m------m------------------m##----m-------------m##########-----m-----------------------------m##---------m--m--m---m------m-
--mmmmmmmmmmmmmmmg-mmmmmm--#---mmmm#-m-mmmm#---mgg-mmmmmmg-mmmmmmmmgg-k#---mmmm--------mmmmmmmmmmmmmmmmmm###-----mmmmmmmmmmmmm#----------#-----mmmmmmmmmmmmmmmmmmmmmmmmmmmmm#----m-mmmmm-mm-mm-mmm-mmmmmm-m
######################################-############################################-----##-#-#-#-##-########------##-##-#-#-##------------------#-##-#-#-##-#-#-##-#-#-#-#-##-----#-####--#--#--##--#-#-#--
