-------------------------------------------------------------------------------------------------------------------------------#-------g-g--------------g--#-------#######-################################
----------------------------------------------------------------------------------------------------------------------------#####################----######################--------------------------------
-----------------------------------------------------------------------------------------------------------------------------------------------------------------------------------------------------------
-----------------------------------------------------------------------------------------------------------------------------------------------------------------------------------------------------------
-----------------------------------------------------------------------------------------------------------------------------------------------------------------------------------------------------------
------------------------------------------mm------------------+------------------------------------------------------------------------------------------------------------mm------------------------------
-----------------------------------------mm-mmmm--------------------------------------------------------------------------------------------------------------------------m?-m-----------------------------
----------------------------------------mm------m--------------------------------------------------------------------mm--------------------------------------------------m#---m----------------------------
----------------------------------------m--------------------------------------mm-----------------------------------mm-mmmm---------------------------------------------m##----m---------------------------
--------------------------------------mm---------m------------mmm--------------m-m---------BBBB--mmm---------------mm----[]m-------------------------------------------m###-----m--------------------------
----------------------------mm----K--m[]---------cm----------m[]-m-----------mm---mmm-----------m[]-m--------------m-----pP-m----------------------mm-----------------m####------m-------------------------
---------------------------mC-m------mpP---------c-m---------mpP--m----------mC---[]-m----------mpP--m-----mm----mm-C----pP--m---------m----------mm-mmm----mm-------m#####-------m-------m----------------
--mmmmmmmmmmmmmmmmmmmmmmmmmmC--mmmmmmmpP---------c--mmmmmmmmmmc ---mmmmmmmmmm-c---pP--mmmmmmmmmmmpP---mmmmmg-mmmmgg-c----pP---mmmmmmmmm-mmmmmmmmmmm-----mmmm#-mmmmmmm######--------mmmmmmm-mmmmmmmmmmmmmmmm
###########################################################################################################################----##-#-#-#---#-#-#-##-------#-##--##-#########--------#-#-#-#---#-#-#-#-#-#-#-
