---------------------------------------------------------------------------------------------------------C--#----------------------------------------------------------------########################------
---------------------------------------------------------------------------------------------------------c--#----------------------------------------------------------------------------------------------
-----------------------------------------------------------------------------------------------------#####--##---------------------------------------------------------------------------------------------
-------------------------------------------------------------------------------------------------B---------------------------------------------------------------------------------------------------------
--------------------------------------------------------------------------------------------------BB#------------------------------------------------------------------------------------------------------
----------------------------------------------------------------------------------*B----------------#----------------------------------------------------------###-----------------------------------------
---------------------------------------------------------------------------------M--B-------------------------------------------------------------------m-----#--------------------------------------------
-----------------------mmmm---------------------------------------------------------------??????--mmm----------------------------------------------------mmmmm---------------------------------------mm----
----------------------mm##-m------------------------------------------------------mm-------------mm#----------------------------------------------------m#####--------------------------------------m#-m---
---------------------m####--m----------mm-m------#????---------------------------m##mm-----------m---mm------------------------------------------------m######m------------mm----------------------m##--m--
--------------------m#####---m-------mmmmmmm------------------------------------m#--#-mmmmmmmmmmm------m-------------------------------------------mmmm######--m----------mm-m-----------mm-------m###---mm
-------------------m######----m-----K-#--#--m-------------mmm---------mmm-------m#--#############-------mm-mm---------mm-------mm------------mm---m##########---m--m---m--m---m---------mm#m-----m####---#-
--mmmmmmmmmmmmmmmmm#######-----mmmmmmm#--#---mmmmmmmmmmmmmgg-mmmmmmmmmkk-mmmmmmmm#----------------------B-mmmmmmmmmmmmk-mmmmmmmk-mmmmmmmmmmmmk-mmmm#-########----mm-mmm-mm-----mmmmmmmmm#-#-mmmmm#####-----
##########################################--########################################----------------------#--#################################################----#--##--#------##-#-#-#--#---#-######-----
