------------------------------#####---?----?#------------------------------------------------------------------------------#######-----------------##-----------------------------------------############-
-------------------------------####---------------------------------------------------------------------------------------########-----------------##----------#########-----------------------------------
------------------------------#####---------------------##---------------------------------------------------------------#########-----------------##--------------------##--------------------------------
--------------------------------###--------------------------------------------------------------------------------------#########-######----------##------------------------------------------------------
-----------------------------mmm-##-------------------------------------------------------------------------------------###########----------------##------------------------------------------------------
-----------------------------m-km-#-------------------------------------------------------------------------------------##-----------------#-------##------------------------------------------------------
-----------------------------m-##m-##------------------------------------------------------------mm-------------------mm#-------------------#########------------------------------------------------------
-----------------------------m-###m--#------#---------------------------------------------------mm-mmm---------------m##mm---------m---------------#######-------------------------------------------------
-----------------------------m-####mm-##--#-------------------------mm-------------------------mm-----m-------------m###--mmm----mm-m---------------------------------------------------mm-----------------
-----------------------------m-#####----##-#----mm---------mm------mm-mmm----------------------m-------m---------?-m###------m--mm#--m-----mm------------------------------------------mm-mmm------------mm
----------------------------mm-#####-m-------M-mm-m--------m-m----mm-----m------mmmm--------mmm------[]-m---------m####--------m###---m---mm-m--------m-------------------------------mm-----m----------m##
----------------------------mY-#####----m------m---m---m--m---m---m-------m-----m[]-m-------m[]------pP--m-------m#####-------m####----m--m---m--m--mm-m--m---m----m----m----mmm-mm-m-m-------m--------m###
--mmmmmmmmmmmmmmmmmmmmmmmmmm-y-#####--mm-mmmmmm-----mmm-mm#----mmm---------mmmmm-pP--mmmmmmm-pP------pP---mmmmmmm######-------#####-----mm-#---mm-mm##--mm-mmm-mmmm-mmmm-mmmm---m#-m-m---------mmmmmmmm####
##############################-#####---#--#-#-#------##--#------##-------###############################################-----######------#------#--###---#--##--#-#--#-#--#-#############-------#-#-#-#####
