--------------------------------------------------------####################-----## ---#-##############------????#-------------pP------#----####------#########-#------------------------------------------
----------------------------------------------------------------------------------##----#-------------------------#---------###################################--#-----------------------------------------
------------------------------------------------------------------------------------------------------------#-----#----##----------------------------###########--#----------------------------------------
--------------------------------------------------------------------------------------#---------------------#------------------------------------------------------#---------------------------------------
---------------------------------------------------------------------------------------#-----------------#########---------------------------------mm---------------####-----------------------------------
----------------------------------------------------B--------------------------BBB----------------------------------------------------------------mm-m--mmm-----m------------------------------------------
------------------------------------------------------------------------------B---------#---------------#----------------------------------------mm---mm---m-----m---------############--------------------
-------------------------------------------------mmm---------------------------------------------------------------------------------------------m-----------mmm--m----------------------------------------
------------------------------------------------mm[]m-------------mmm---------mm----------------------mmm------------------mm-------------------m-----------mg##---m--------------------------------mm-----
------------------------------------mmm--------mm-pP-m-----------mm[]m-------mm-mmm----B-------------m##mm-----------------m-mmm---------------m#-----------####----m-----mm-----------------------mm-mmm--
------------------------------mmm--m[]-m-------m--pP--m---------mm-pP-m-----mm-----mm---B-----------m###--m------??-------m-----mmm-----------m##----------#####-----m---mm-m------mm---mm--------mm-----mm
------------------------------mC-m-mpP--m----mm---pP---m--------m--pP--m----m------[]m-------------m###----m----------m--m#-----[]-m---------m###---------######------m--m---m--m--m-m--m-m-------m------##
--mmmmmmmmmmmmmmmmmmmmmmmmmmmm-c--mmpP---mmmmgg---pP----mmmmmmmm---pP---mmmm-------pP-mmmmmmmmmmmmm####-----mmmmmmmmmm-mm#------pP--mmmmmmmmm####-------#########------mm-----mm-mm---mm---mmmmmmm---------
####################################################-----#-#-#-#---pP----#-#-------pP--####-#-#-#-#####------#-#-###-#--#-------pP---#-##-#-#####-------########--------#------#--#----#----##########-----
