---------------------------------------------------------------------------------------------------------------------------------------------------------------------------####----------------#-----------
----------------------------------------------------------------------------------------------------------------------------------------------------------------------------###----------------------------
-----------------------------------------------------------------------------------------------------------------------------------------------------------------------------####--------------------------
--------------------------------------m-------------------------------------------------------------------------------------------------------------------------------mm-m-------#######-------------------
-----------------------------------mmm-m-----------------------------------------------------------------------------------------------------------------------------mm-m----------------------------------
----------------------------------m###--m------------------------BBBBBBBBBBBBBBBBBBBBBBBB?BBBBBBBBBBBBBBBBBBBBBBBBB??BBBBBBBB---------------------------------------mm----------m--------------------------
---------------------------------m####?--m-----------------------------------------------------------------------------------------------------------------------mm-m------------m-------------------------
--------------------------------m#####----m---------------------------------------------------------------------------------------------------------------------mm-m-----------m--m------------------------
-------------------------------m######-----m-------------------mmmmmmmmmmmmmmmmmmmmmmmmmmmmmmmmmmmmmmmmmmmmmmmmmmmmmmmmmmmmmm--------------mm-------------------m-##------##mmm#---m-----------------------
------------------------------m#######------m------------------mKBBB?B??????????????????????????????????????????????????????-m-------------m-m----K----------mmm--##-----#######----m-----mm-------------mm
-----------------K-----------m########-------m---------------K-m--------------------------------------------------------------m---------mmm---m--------------m[]--##-----#######-----m---mm-mmm---------mmm
----------------------mm----m#########--------mm-m------------m#---------------------------------------------------------------m--------m[]----mmmmmmmmmmmmmm-pP--##-----#######------m--m-----m--------m--
--mmmmmmmmmmmmmmmmmmmmg-mmmm##########--------#-m-mmmmmmmmmmmm##----------------------------------------------------------------mmmmmmmm-pP----#################--##----########-------mm-------mmmmmmmm---
###############################################################################################################################--############---------------------##############--------#--------##########
