--------------------------------------------------------------------------------------------------------------------------------------------------------------------------------------------------------###
-----------------------------------------------------------------------------------------------------------------------------------------------------------------------------------------------------------
-----------------------------------------------------------------------------------------------------------------------------------------------------------------------------------------------------------
-----------------------------------------------------------------------------------------------------------------------------------------------------------------------------------------------------------
-----------------------------------------------------------------------------------------------------------------------------------------------------------------------------------------------------------
---------------------------------------+-------------------------------------------------------------------------------------BBB---------------------------------------------------------------------------
---------------------------------------------------------------------------------------------------------------------------BBB------------------------------------------------+----------------------------
------------------------------------------------------------------------------------------------------------------------------------------------------------------------------------------------------mm---
----------------------------------------------------------------mm-----------------------------------------------------------------------------------------------------------------------------------mm-mmm
-------------------------mmm----BMBB*--m----BBB#---------------mm-mmmmm----------------------------------------------------mmm------------------------------------------------mmm-------------------mm---[]
-------------------mmm--m[]-m---------mVmm------mmm---KK-K----mm----[]-m----?----------------------K-----------mmm--------m[]-m-----------------------------------K----------m[]-m------------------m----pP
-------------------mC-m-mpP--m--------m[]-m------C-m-----------C----pP--m-------------mmm-----------mm--------m[]-m-------m[]--m--------mm-------mmm------mmm---------mmm----mpP--m-------mmm-----mm-----pP
--mmmmmmmmmmmmmmmmm-c--mmpP---mmmmmmmmmpP--mmmmmmc--mmmmmmmmmmmc----pP---mmmmmmmmmmmmmgg-mmmmmmmmmmmh-mmmmmmmmmpP--mmmmmmmmpP---mmmmmmmmg-mmmmmmmgg-mmmmmmgg-mmmmmmmmmgg-mmmmmpP---mmmmmmmgg-mmmmmgg-----pP
########################################################################################################################################################################################################## 
