-----------------------------------------------------------------------------------------------------------------------------------------------------------------------------------------------------------
-----------------------------------------------------------------------------------------------------------------------------------------------------------------------------------------------------------
-----------------------------------------------------------------------------------------------------------------------------------------------------------------------------------------------------------
-----------------------------------------------------BB----------------------------------------------------------------------------------------------------------------------------------------------------
-------------------------------------------------------B--------------------------------------------------------------------------------------------------------------------------------------------------m
------------------------------------------------------m--------------------------------------------------------------------------------------------------------------------------------------------------m#
----------------------------------------------------mmmm-------------------------------B-------------------------------------------------------------------------M--------------------------------------m##
------------------------------------mmmmmmmmmmmmmmmmm#--m----------------------------------------------------------------------------------------------------------------------------------------------m###
--------------------------------mmmm##################---m----------------------------------------------------m---------------------------------------------------------------------------------------m####
-------------------------------m######################----m----???----???M---mm--BBB-------------------------m#m-----------B??B????------------------------------mm----------------------------------m#####
------------------------------m#######################-----m----------------mm-m------mmm--------------------m#-m-----mmmm--------------------mm------------K---m#-m--------------------------------m######
-----------------------------m#########################-----m---------------m#--m----mm#-m------------mm-----m#--m----m[]-m------------mmm---m#-m---------------m#--m-----mmm----mmm----mm---------m#######
--mmmmmmmmmmmmmmmmmmmmmmmmmmm####-####-----------------------mmmmmmmmmmmmmmm-#---mmmmm-#--mmmmmmmmmmmmk-mmmmmm#---mmmm-c---mmmmmmmmmmmmgg-mmmm#--mmmmmmmmmmmmmmmm#---mmmmmgg-mmmmkg-mmmmg-mmmmmmmmm########
##################################-----------------------############################--####################################################################################################################
