-------------------------------------------------------------------------------------------------------------------------------------------###########################################-####################
-----------------------------------------------------------------------------------------------------------------------------------------------------------------------------------------------------------
-----------------------------------------------------------------------------------------------------------------------------------------------------------------------------------------------------------
-----------------------------------------------------------------------------------------------------------------------------------------------------------------------------------------------------------
------------------------------------------------------------------------------------------------------------------------------------------------------m----------------------------------------------------
---------------------------------------------------B-----------------------------??B??????-----------------------------------------------------------m-m--------------------------------------------------m
-------------------------------------------m----------#---------------------------------------------------------------------------------------------m#--m------------------------------m-----------------m#
--------------------------------------------mmmmmmmm---######--------------------------------------------------------------------------------------m##---m----------------------------m-m---------------m##
-------------------------------------------m#######-m--------###---------mmm--------h-------------------------------------------------------------m###----m--------------------------m#--m-------------m###
------------------------------------------m#######---m----------##------mm[]mm---????B????----------------------------------------------mmm------m####-----m------------------------m##---m-----------m####
------------------------m--------mmmmmmmmm########----m----------------mm-pP--m-------------------------------------K----mmmm-------K--m[]-m----m#####------m----------------------m###----m---------m#####
-------------mmm------mm-mm-----m#################-----m--m--m--m------m--pP---m---------------mm--------mm---------------[]-m---------mpP--m--m######-------m---m-----m-------m--m####-----m----m--m######
--mmmmmmmmmmmgg-mmmmmmgg-g-mmmmm#-################------mm-mm-mm-mmmmmm---pP----mmmmmmmmmmmmmmmg-mmmmmmmmk-mmmmmmmmmmmmmmmpP--mmmmmmmmmmpP---mm#######--------mmm-mmmmm-mmmmmmm-mm#####------mmmm-mm#######
###################################################------#--#--#--########################################################################----########--------#-#---#-#--##-#-#--######-------#-#--########
