---------------------------------------------------------------------------------------------------------------------#####################################-------pP---###------------##------------------##
--------------------------------------------------------------------------------------------------------------------------------------------------------###------pP---###------------##--------#---------##
-----------------------------------------------------------------------------------------------------------------------------------------------------------#####-pP---###------------##---#########------##
-------------------------------------------------------------------------------------k--------------------------------------------------------------------------#pP---###------------##------------------##
------------------------------------------------------------------------------------BM?????----------------------------------------------------------------------########-----------###--------------------
-----------------------------------------------------------------------------mm----------------mm--------------------------------------------------mm-----------------#################--------------------
----------------------------------------------------------------------------m#-m---------------m#mm-----------------------------------------------mm-mmm----------------------------###--------------------
---------------------------------------------------------------------------m##--m---------------#+-m---------------------------------------------mm-----m--------------------------------------------------
------------------------------mmmmmmmmmmmmmmmmmmmmmmmmmmmmmmmmmmmmmmmmmmmmm###---m---??????--mm-#---m--------------------------------------------m---------------------------------------------------mm----
-----------------------------m################################################----m--K------m[]-#----m------Kmmm------m------------------mmmmmmmm--------m----mm----------------mm------------------mm-mmm-
----------------------------m#################################################-----m--------mpP-#-----m------mC-m----m#m----------------m########------------mm-mmm---m---mm---mm-m-----m----------mm-----m
-------------------mm------m##################################################------mmmmmmmmmpP-#------mmmmmm-c--mK--m#-m--------------m#########--------km--m-----m--mmmm--m--m---m--mm-m----m----m-------
--mmmmmmmmmmmmmmmmmk-mmmmmm#####################################################################################--mmmm#--mmmmmmmmmmmmmm##########--------#-mm-------mm-###---mm-----mm##--mmmm-mmmm--------
################################---------------------------------------------------------------------------------######---#-#-#-#-#-#-###########--------##-#-----[]-#-###----#------###---#-#--#-#-------#
