--------------------------------------------------------------#####################################################################################################----------------------------############
-------------------------------------------------------------------------------------------------------------------------------------------------------------------------#######---------#-----############
-----------------------------------------------------------------------------------------------------------------------------------------------------------------------------------------#-----############
-----------------------------------------------------------------------------------------------------------------------------------------------------------------------------------------##----############
---------------------------------------------------------g----------------------------------------------m------------------------------------------m------------------------------------------#############
---------------------------------------------------BBBBBBBB*-----------------------------------------mmm-m---------------------------------------mm-m-----------------------------------------#############
---------------------------------------------B--------------B---------------------------------------m###--m-------------------------------------m##--m----------------------------------------#############
----------------------------------------------BBB-------------mmmm---------------------------------m####---m-----------------------------------m###---m---------------------------------------#############
------------------------------------------mmmm---------------mm##-m-------------------------------m#####----m---------------------------------m####----m-------------mm-----------------------#############
-----------------------------------------mm[]-m----BBBBBBBBBmm-##--m-----------------------------m######-----m-------------------------------m#####-----m-----------mm-mmm---------mm-------*-#--##########
----------------------------------------mm-pP--m------------m--##---m---------------------------m#######------m-----------------------------m######------m---------mm-----m-------mm-m---------------------
---------------mm----mm-----------------m--pP--------------m---##----m----m---------------mmm--m########-------m-----------m----m----m-----m#######-------m---mm---m-------m------m---mmm-----mmmmmmmmmmmmm
--mmmmmmmmmmmmmk-mmmmk-mmmmmmmmmmmmmmmmm---pP---mmmmmmmmmmmh---##-----mmmm-mmmmmmmmmmmmmmm##-mm#########--------mmmmmmmmmmm-mmmm-mmmm-mmmmm########--------mmm#-mmm---------mmmmmm-------mmmmmm-k##########
#############################################----############--##------#-#-g-#-#-#-#-#-#-#-#--##########--------#-#-#-#-#-#--#-#--#-#--##-#########--------#-#--#-#----------#-#-#--------#O-#--###########
