-----------------------------------------------##--------##################################################################################################################################################
----------------------------------------------###--------##################################################################################################################################################
----------------------------------------------###-------###################################################################################################################################################
----------------------------------------------###-------###################################################################################################################################################
----------------------------------------------###-------###################################################################################################################################################
----------------------------------------------#--##########################################################################################################################################################
----------------------------------------------m--------####################################################################################################################################################
--------------------------------------------mmmm--------###################################################################################################################################################
--------------------------------------------m#--m--------#######################################################################################pP#########################################################
-------------?????-----------------------mmm--------------#################################################################################################################################################
---------------------------------------mmmm#-----mm---mm---######################################################---------------------------------------------------#######################################
---------------------------------------m#-------##-m--m----------------------------------------------------------mmmmmmmmmmmmmmmmmmmmmmmmmmmmmmmmmmmmmmmmmmmmmmmmmmm---------------------------------------
--mmmmmmmmmmmmmmmmmmmmmmmmmmmmmmmmmmmmm-#-------##--mm--mmmmmmmmmmmmmmmmmmmmmmmmmmmmmmmmmmmmmmmmmmmmmmmmmmmmmmmmm###################################################mmmmmmmmmmmmmmmmmmmmmmmmmmmmmmmmmmmmmmm
##########################################------##---#---##################################################################################################################################################
