-----------------------------------------------------------------------------------------------------------------------------------------------------------------------------------------------------------
-----------------------------------------------------------------------------------------------------------------------------------mm----------------------------------------------------------------------
-----------------------------------------------------------------------------------------------------------------------------------m-m---------------------------------------------------------------------
---------------------------------------------------------------------------------------------------------------------------------mm---m------------------mm------------------------------------------------
-----------------------------------------------------------------------------------------------------------------------------B---m#----m-----------------m-m-----------------------------------------------
----------------------------------BBBBBB------------------------------------------------------------------------BBBBBB*------K-mm-------m------------mmmm--------------------------------------------------
---------------------------------------------------------M-------------------------------------M-----------------------------mmm#--------m----------m####--#m----------------------------------------------
------------------mm-------------------------------------------------------------------------------------------------------Kmm#-------##--m--------m#####--#-m---------------------------------------------
-----------------m#-m----------mmmmmmmm--------------------------------------------------------------------mm---------------m?#------------mm-----m######--##-m-------------------------------------------m
------BMB-------m##--m--------KK#+BB?B-m-----------------mm------------------------------------mm---------mm#mmBBBBBBBB----m---------------#-mmmmm#######--##--m---------------mm-------------mmmmmmmmmmmm#
---------------m###---m-------mm#-------m-------K-------m#-m------m---------------------------m#-m-------mm-#+-m----------mC---------------###################--m----mm-------m#-m-------------############
--------------m####----m-------##--------m-----------K--m#--m---mm-mm--------------------mm---m#--m------m--#---m---mm----m#----------------------------------#--mmmmk-mmmmmmmm#--mmmmmmmmmmmmm############
--mmmmmmmmmmmm#####-----mmmmmmm-#---------mmmmmmmmmmmmmmm#---mmmgg-g-mmmmmmmmmmmmmmmmmmmmk-mmmm#---mmmmmm---#----mmmh-mmmmmC###--------------------------------############################################
############################################################################################################################-------------------------------------------------------------------------------
