-----------------------------------------------------------------------------------------------------------------------------------------------------------------------------------------------------------
-----------------------------------------------------------------------------------------------------------------------------------------------------------------------------------------------------------
-----------------------------------------------------------------------------------------------------------------------------------------------------------------------------------------------------------
-------------------------------------------------------------------------------------------------------------------------------------------------------------------------------------------------m---------
-----------------------------------------------------------------------------------------------------------------------------------------------------------------------------------------------mm-m--------
----------------------------------------------------------------------------------------------------------------------------------------------------------------------------------------------m##--m-------
-------------------------------------------M-------------------------------M-----------------------------------------------------------------------------------------------------------------m###---m------
--------------------------------------------------------------------------------------------------------------------------------mm----------------------------------------------------------m####----m-----
----------------------------------------------------------------------------------------------------------mm-------------------m[]------------------------------------------m--------------m#####-----m----
---------------------?---------------------mm------------------------------mm-----------------------------m#mmmmm-------------mmpPmm--??????------------------------------mm#m------------m######------m---
----------------------------m--------mm---m#-m---------------m---------K--m#-m---------------------------mm#####-m-----------mm-pP--m---?--------------------------------m[]#-m---K------m#######-------m--
---------------------------m-mm-----m#-m--m#--m---mm-------mm-mm----------m#--m-mmm----mm-----mmm---------######--m----------m--pP---m------mmm----mm--------mmm---------mpP#--m--------m########--------m-
--mmmmmmmmmmmmmmmmmmmmmmmmmg-g-mmmmmm#--mmm#---mmmk-mmmmmmmgg-g-mmmmmmmmmmm#---mgg-mmmmk-mmmmmgg-mmmmmmmmm##-###---mmmmmmmmmm---pP----mmmmmmgg-mmmmk-mmmmmmmmgg-mmmmmmmmmmpP#---mmmmmmmm#########-------#-m
###########################################################################################################################################################################################################
