-----------------------------------------------------------------------------------------------------------------------------------------------------------------------------------------------------------
-----------------------------------------------------------------------------------------------------------------------------------------------------------------------------------------------------------
-----------------------------------------------------------------------------------------------------------------------------------------------------------------------------------------------------------
-----------------------------------------------------------------------------------------------------------------------------------------------------------------------------------------------------------
-----------------------------------------------------------------------------------------------------------------------------------------------------------------------------------------------------------
-----------------------------------------------------------------------------------------------------------------------------------------------------------------------------------------------------------
------------------------------------------------------------------------------------------------------------------------------------------------------------------M--------------------M-------------------
---------------------------------------------------------------------------------------------------------------------------------------------------------------------------------------M-------------------
-----------------------------------------------------------------------------------------------------------------------------------------------------------------------------------------------------------
-------------------------------------mmm------------------------mmm----------------------------------------------mm-----------------------------------------------mm-------------------mm------------------
------------------------m-----------m[]-m----------------------m[]-m------------------------mmmm----------------m#-m----------------------------------m----------m#-m-----------------m#-m-----------------
-----------------------m-mmm--------mpP--m---Kmmm--------------mpP--m-------mm------mmm------[]-m--------mm-----m#--m--mmm----mm-----mmm-------------m#m---------m#--m-----mmm--------m#--m---mm---------mm
--mmmmmmmmmmmmmmmmmmmmmg-gg-mmmmmmmmmpP---mmmmgg-mmmmmmmmmmmmmmmpP---mmmmmmmg-mmmmmmgg-mmmmmmpP--mmmmmmmmh-mmmmmm#---mmgg-mmmmk-mmmmmgg-mmmmmmmmmmmmmm#-mmmmmmmmmm#---mmmmmgg-mmmmmmmmm#---mmmk-mmmmmmmmmgg
###########################################################################################################################################################################################################
