-----------------------------------------------------------------------------------------------------------------------------------------------------------------------------------------------------------
-----------------------------------------------------------------------------------------------------------------------------------------------------------------------------------------------------------
-----------------------------------------------------------------------------------------------------------------------------------------------------------------------------------------------------------
-----------------------------------------m-----------------------------------------------------------------------------------------------------------------------------------------------------------------
---------------------------------------mm-m----------------------------------------------------------------------------------------------------------------------------------------------------------------
--------------------------------------m##--m---------------------------------------------------------------------------------------------------------------------------------------------------------------
-------------------------------------m###---m---------------------------------------------------------------------------------------------------------------------------------------------B----------------
------------------------------------m####----m-------------------------------------------------------------------------------------------------------------------------------------------------------------
-----------------------------------m#####-----m------------------------------------------------------------------------------------------------------------------------------------------------------------
----------------------------------m######?-----m------------------------------M-----------------------------------------------------------------------------------------------------------mm---------------
---------------------------------m#######-------m------------------K----K----------------------m---------K------------------------m-------------------------------------mmm--------------m#-m--------------
--------------------mmm---------m########--------mm-m-------------------------mm--------------m-mm--------mm-------------mm------m-mm-----mm-----------------------------#-m--------mm---m#--m--------mmm--
--mmmmmmmmmmmmmmmmmmgg-mmmmmmmmm#########--------#-m-mmmmmmmmmmmmmmmmmmmmmmmmmk-mmmmmmmmmmmmmmg-g-mmmmmmmmk-mmmmmmmmmmmmmg-mmmmmmk-k-mmmmmk-mmmmmmmmmmmmmmmmmmmmmmmmmmmmm#--mmmmmmmmk-mmmm#---mmmmmmmmgg-mm
###########################################################################################################################################################################################################
