--------------------------------------------------------------------------------------------------------------------------------------------------------------------------------------------###############
-----------------------------------------------------------------------------------------------------------------------------------------------------------------------------------------------------------
-----------------------------------------------------------------------------------------------------------------------------------------------------------------------------------------------------------
----------------------------------------------------------------------------------------------------------m-----------------------------------------------m------------------------------------------------
--------------------------------------------------------------------------------------------------------mm-m--------------------------------------------mm-m----------------------------------------------m
-------------------------------------------------------------------------------------------------------m##--m------------------------------------------m##--m--------------------------------------------mg
---------------------------------------------------B--------------------------------------------------m###---m----------------------------------------m###---m----------------------------------------m-m##
-----------------------------------------------------------------------------------------------------m####----m--------------------------------------m####----m--------------------------------------m-m###
-----------------------------------mmmmmmmmmmmmmmmm-------------------------------------------------m#####-----m------------------------------------m#####-----m------------------------mm-----------mg####
----------------------------------m###############Bm---------mm------------------------------------m######------m----------------------------------m######------m----------------------mm-mmm--------m#####
---------------------------------m################----------mm-m-------------------K--mmmm--------m#######-------m--------------------------K-----m#######-------m--------mmm--------Kmm-----m------m######
-------------mm----mm-----------m#################--m-------m#--m----------mm----------[]-m------m########--------mm-m----mm-m---------------mm--m########--------mm-m----mC-m--------mC------m----m#######
--mmmmmmmmmmmk-mmmmk-mmmmmmmmmmm##################---mmmmmmm-#---mmmmmmmmmmk-mmmmmmmmmmpP--mmmmmm#########--------#-m-mmmm#-m-mmmmmmmmmmmmmmmk-mm#########--------#-m-mmmm-c--mmmmmmmm-c-------mmmm########
###################################################--?-###################################################################################################################################---#--###########
