-----------------------------------------------------------------------------------------------------------------------------------------------------------------------------------------------------------
-----------------------------------------------------------------------------------------------------------------------------------------------------------------------------------------------------------
-----------------------------------------------------------------------------------------------------------------------------------------------------------------------------------------------------------
-----------------------------------------------------------------------------------------------------------------------------------------------------------------------------------------------------------
---------------------------------------------------------------------------------------------------------------------+-------------------------------------------------------------------------------------
-------------------------------------------------------------------------------------------------------BBBBBBBBBB------------------------------------------------------------------------------------------
------------------------------------B---------------------------------------------------------------------------------------------------------------------------M------------------------------------------
-----------------------------------------------------------------------------------------------------------------------------------------------------------------------------------------------------------
--------------------------------------------mmm------------------------------------------------------mm------------------------------------------m---------------------------------------------------------
------------------------------------mm-----mm[]mm------------------------mmm------------------------mm#mmBBBBBBBB----mmm-------K------------------m-------------mm-----------------------------------------
-----------------------------------m#-m---mm-pP--m--------??????--------m[]-m-----------------------m-#--m----------m[]-m-----mmmm--------------mm-m-----------m#-m-----m----------------------------------
---------------------mmm-----------m#--m--m--pP---m-------------mmm-----mpP--mm---mmm---mmm-------mm--#---m---------mpP--m----m[]-m--------------#--m----------m#--m--mm-mm-mm---mm------mmm---mm--------mm
--mmmmmmmmmmmmmmmmmmmgg-mmmmmmmmmmmmC---mm---pP----mmmmmmmmmmmmmgg-mmmmmmpP--g-mmmgg-mmmgg-mmmmmmmgg--#----mmmmmmmmmmpP---mmmm-pP--mmmmmmmmmmmmmm#---mmmmmmmmmmm#---mmgg-g-mg-mmmk-mmmmmmgg-mmmk-mmmmmmmmk-
###########################################################################################################################################################################################################
