----------------------------------------------------------------------------------------------------------------###################################-----------------##---------##--------------------#-----
----------------------------------------------------------------------------------------------------------------###################################-----------------###--------##--------------------#-----
----------------------------------------------------------------------------------------------------------------##################################################--####------###-------------------##-----
---------------------------------------------------------------------------------------------------------------------------------------------------------------------####----####-------------------##-----
-----------------------------mm-----------------------------------------------------------------------mm------------------------------------------------------------#--------####-------------------##-----
----------------------------m#-m------------------------------------B----BBMM------------------------mm-mmm----------------------------------------------------------------######-------------------##-----
-------------------------mmm##--m-------------------------------------------------------------------mm-----m----------------------------------------------------------------##################------##-----
------------------------mgg###---m------------------------------m-mmm-------------------------------m-------m---------------------------------------------------------------------------------#-----##-----
------------------------m#####?---m----------------------------m-m#B----------------------------mmmm---------m---------------------------------------BBBBBBBBBBBBBB----------------------------#---###-----
-----------??----------m######-----m---------?-???-------------mg##-Bm---B?BBB?----m---#BBBB-----m[]---------Vmm----------------------------------------------------mm--------------------------##-##-#----
----------------------m#######------m--------------------------m###--------------Kmmmm----------m-pP---------[]-m--------------------------------------------------mm-m---mm------------mm---mm---#-#m-#---
-------------mmm-----m########-------mm-m---------------------m####---m------------[]-m---------m-pP---------pP--m------------------------------mmmmmmmmmmmmmmmmm--m-k-m--m-m---mmm--m--m-m--m-m-----#m----
--mmmmmmmmmmmgg-mmmmm#########-------#-m-mmmmmmmmmmmmmmmmmmmmm#####----mmmmmmmmmmmmpP--mmmmmmmmm--pP--k------pP---mmmmmmmmmmmmmmmmmmmmmmmmmmmmmm####BBBBBBBBBBBB-mm--#--mm---mmmmg-mm-mm---mm---mmmmm--mmmm
###############################################################################################################---############################h#####--------------#--##--#-----###--#--#----#----#-#----#-#
