------------------------------------------------------------------->############################-----------------------?-----------------------------------------------------------------------------------
-----------------------------------------------------------------------------------------------------------------------------------------------------------------------------------------------------------
------------------------------------------------------------------------------------------------############-----------------------------------------------------------------------------------------------
------------------------------------------------------------------------------------------------------------------------?----#-----------------------------------------------------------------------------
-------------------------------------------------------------------------------------------------------------------------?---------------------------------------------------------------------------------
------#????M?????----------m-------------------------------------------------------------------------------------------------------------------------------------------------------------------------------
------#-------------------m-mm--------------------------------------------m---------------------m---------------------#------------------------------------------------------------------------------------
------#-------------------mg#-m------------------------------------------m-m------------------mmmm---------------------##----------------------------------------------------------------------------------
------#k------------------m##--mmm--------------------------mm-----------m--m----------------m##--m--------------mm------M----------------------------------------------------------------------mm--mm-----
------#?????MM???M-------m###--BB-m------------------------mm-mmm--------mC--m--------------m##?-?-m------------mm-mmm---------------mm----------mm--------mm-----mm-----mm----------mm--------mm-mm>-m----
------------------------m####------m-----------------------m-----m------m###--B------------m###-?---m----m-----mm-----m---mm---mm---mm-m---mm---mm-mmm----mm-m---mm-m---mm-m---mm---mm-mmm----mm---B---m---
-----------------------m#####-------m---------------------mC------m----m####--m----m------m####------m--m-m--m-m---------m--m--m-m--m---m--m-m--m-----mm--m---m--m---m--m---m--m-m--m-----m---m---------m--
--mmmmmmmmmmmmmmmmmmmmm######--------mmmmmmmmmmmmmmmmmmmmmmc-------mmmm#####---mmmm-mmmmmm#####-------mmB--mmmm--------mm#---mm---mm-----mm---mm------K-mm-----mm-----mm-----mm---mm-------mmm-----------mm
##############################################################------#-######----#-#--#-#-######--------#----#-#---------#-----#----#------#----#---------#------#------#------#----#--------####----------#
