----------------------------------------------------------------------------#####################----------------------#####################################-------------------##########################--
-----------------------------------------------------------------------------------------#########---------------------------------------------------------------------------------------------------------
-----------------------------------------------------------------------------------------------------------------------------------------------------------------------------------------------------------
------------------------------------------######------------------------------------------------------------------------------------------------------------mm--#######----------------------------------m-
----------------------------------------------------------------------------------------mm-mm-----m-------------------------------------------------------mm--m-------------------------------------------m
-----------------------BBB---------------------------------B--------------------------mmm-m----mmm-m------------------------------------------------------mg---m--------------------------------------mmm--
-------------------m-----------------------------------------------------------------mmm-----mmg##--m----------------------------------------------------m##----m--------------------------------------##--
--------------------mmm----------------mmmm---------------B-------------------------mB--------####---m--------------------------------------------------m###-----m------------------------------------m##--
-------------------m##Bm-------------mm----m--------------------mm------mm---------m#--------#####----m-----------mm-----------------------------------m####------m----------------------------------m###--
------------------m###??mm----------mmB-----m----------mm------mm-mmm--mm-m-------m##--------#####-----m---------mm-mmm-------------------------------m#####-------m-----mm-------------------------m####--
-----------------m####--B-m--------mm--------m--------mm-m----mm-----m-m---m-----m###-------######------m-------mm-----m-------------------m---------m######--------m---mm-mmm---------------------m#####--
----------------m#####-----m-------m----------m--mm---m---m---m-------m-----m---m####------#######-------m--m-m-m-------m------------m----mmm----m--m#######---------m--m-----m----m------m----m--m######--
--mmmmmmmmmmmmmm######------mmmmmmm------------mmm-mmm-----mmm--------#------mmm#####------#######--------mm-m-m---------mmmmmmmmmmmm-mmmm#-#mmmm-mm########----------mm-------mmmm-mmmmmm-mmmm-mm#######--
############################-#########----------#---##----########-------------######-----########---------######---------#-#-#-#-#-#--#-#--#-#-#--#########-----------#--------#-#--#-#-#--#-#--########-#
