---------------------------------------------------------------------------------------############-----------------######--------------------------######-------------------------------------------------
----------------------------------------------------------------------------------------------------------------------------###############################------------------------------------------------
----------------------------------------------------------------------------------------------------------------------------------------------------------------------------------------------#------------
---------------------------------------------------------------------------------------------------------------------------------------------------------------------------------------mmmmm---######------
---------------------------------------------------------------------------------------------------------------------------------------------------------------------------------------m#---m--------------
--------------------------------------------------------------------------------------------------------------------B-----------------------------------------------------------------mg#----m-------------
-------------------------------------------------------------------M-------------------------------------------------BBBBB-------------------------------mBB-------------------------mm##-----m------------
-------------------------------------------------------------------------------------------------------------mmm----------------------------------------m-m---------------------------###------m-----------
-----------------------------------------------------------------------------mm-----------------------------mm[]m--B------------------------------------mg--B------------------------m###-------m----------
-------------------------------------------------------------------mm-------mm#mmBBBBB---------------------mm-pP-m--B-------mm--------------------------mC-mm-----------------------m####--------m-----mm--
-----------------mmm----------------K-------Kmm----mm-------------m#-m-----mm-#+-m---B-B-------------------m--pP--m--BBBBB-mm-m------------------------m###B-m---------------------m#####---------m---mm-mm
-----------------mC-m-----------------------mC-m--mC-m------------m#--m----m--#---m--KBB-----------mmmmmmmm---pP---m------mm---m----------------------m####---m-------------------m######----------m--m----
--mmmmmmmmmmmmmmm-c--mmmmmmmmmmmmmmmmmmmmmmmmc--mmmc--mmmmmmmmmmmmm#---mmmm---#----mmmmmmmmmmmmmmmm#############----mmmmmm#-----mmmmmmmmmmmmmmmmmmmmmm#####----mmmmmmmmmmmmmmmmmmm#######-----------mm-----
#########################################################################################-#-#-#-#-#-----------------#k-#-#-------#-#-#-#-#-#-#-#-#-########-----##########################-----------#-----
