--------------------------------------------------------------------------------------------------------------------------------------------------------------------------------------------------------?g#
---------------------------------------------------------------------------------------------------------------------------------------------------------------#----------------------------------------m##
--------------------------------------------------------------------------------------------------------------------------------------------------------------------------------------------------------m##
------------------------------------------------------------------------------------------------------------------------------------------------------------------------------------------------------mm###
-------------------------------------------------------------------------------------------------------------------------------------------------------------------------------------------------------####
------------------BBBBBBBBBBBBB?BBB------------------------------------------------------------------------------------------------------------------------------------------------mm-----------------m####
----------------mm--------------------------------------------M--------------------------------------------------------------------------------------------------------------------m-m---------------m#####
---------------mm-mm---------m---------------------------------------------------------------------------------------------------------------------------------------------------mm---mm------------m######
--------------mm----mmmmmmmmm-m---------------------------------------------------mm--------------------------------------------------------------------------------------------mm#---#-mmmmmmmmmmmm######-
--------------m----???????BBB--m--?---------------------------mm-----------------mm#mm--------------------------------------------------------------mm----mmm-------------------m-----###################--
------------mm----B-------------m-------------K----------K---m#-m---------------mm-#+-m------------mm------Kmm-------------------------------------mm-m---mB-m-----mm--mm-----mm---------------------------
------------mC-------------------m-----mm-----K--------------m#--m--------------m--#---m----K-mm--mC-m-----m#-m-----------------mm-----------------m---mmm----mK-mmm-mmB-m-m--m#---------------------------
--mmmmmmmmmm-c----B---------------mmmmmh-mmmmmmmmmmmmmmmmmmmmm#---mmmmmmmmmmmmmm---#----mmmmmmh-mmmC--mmmmmm#--mmmmmmmmmmmmmmmmmh-mmmmmmmmmmmmmmmmm----######--mmmm---B---m-mm----------------------------m
###################################################################################################################################################-------------#---------B--#----------------------------#
