-----------------------------------------------------------------------------------------------------------------------------------------------------------------------------------------------------------
----------------------------------------------------------------------------------------------------------------------------#------------------------------------------------------------------------------
----------------------------------------------------------------------------------------------------------------------------------------------------m------------------------------------------------------
--------------------------------------------------------------------------------------------------------------------------------------------------mm-m--#--------------------------------------------------
-------------------------------------------------------------------------------------------------------------------------------------------------mmg--m----------------------------------------------------
----------------------------------------------------------------BBB?????------------------------------------------------BB-----------------------m##---m---------------------------------------------------
------------------------------------------------------------------------?-------------------------------------------------B---------------------m###----m--------------------------------------------------
-----------------------------------------------------------------------------------------------------------------------m---B-------------------m####--------###--------------------------------------------
----------------Kmm--------------------------------------mmm--+-----h----------------------------------------mmmmmmmmmm-m---B------m----------m#####-----m------------------mm-----------------------------
----------------mm-m------------------------------------mm[]mm????????Mh------------------------------------m##########B-m------mmm-m--------m######------m----------------mm-mmm-----mm-------------------
---------------mm---m----------------------------------mm-pP--m--------??----------------------------------m###########---m----mmB#--m------m#######-------m---mm----mm---mm-----m---mm-mmm----------------
---------------mc----m--------------mm------K----------m--pP---m------------------------------------------m############----m--mm------m----m########--------m--m-m---m-m--m-------m--m-----mm-m------------
--mmmmmmmmmmmmm-B-----mmmmmmmmmmmmmmh-mmmmmmmmmmmmmmmmm---pP----mmmmmmmmmmmmmmmmmmmmmmmmmmmmmmmmmmmmmmmmmm#############-----mmm--------mmmm#########---------mm---mmm---mm---------mm------#-m-mmmmmmmmmmmm
#######################################################################################################################------#---------#############----------#----##----#----------#------################
