----------------------?---------------pP-----pP----##[]-----------------------------------------------------------------####-------------------------------------------------------------------------------
-----------------------###------------pP-----##----##pP--------------#------------------------------------------------#####################-----------------------------------------m----------------------
-------------------------###----------##-----------##pP--mm----------##-----------------------------------------------------------------------------------------------------------mm-m---------------------
--------------------------------------------------###pP-mm-mmm-------------------------------------------------------------------------------------------------------------------m##--m--------------------
--------------------------------------------------###pPmm-----m-----------------------------------------------------------------------------------------------------------------m###---m-------------------
---------------------------------------------------####m-------m----------#----#-----------------------------------------------------------------------------------------------m####----m------------------
----------------------------------------------------------------m----------#----#--------------------------------------------B------------------------------------------------m#####-----m-----------------
-----------------------------------------------------------------m----------------------------------------------------------K-BBBBBBBBBBBBBBB--------------------------------m######------m----------------
-----------------mmm-------------B--------------------------------m---------------------------------------------mm-----------------------------------------------mm---------m#######-------m---------------
----------------mm[]m-------------BB--------mm--------m------------m----------mm-------mm-----mm---------------mm-mmm------mmmm---------------------------------mm-mmm-----m########--------mm-m-----------
---------------mm-pP-m-?------------mm-----mm-mmm----mV-------------m----mm--mm-m-m---mm-m---mm-m-------------mmY----m-----m#B-mmmmmmmmmmmmmmm-----------------mm-----mmmmm#########--------#-m-mmmmmmmmmmm
---------------m--pP---------mmm----m-m----m--[]-m--m#[]-------------m--mm-m-m---m-m--m---m--m---m------mm----m-y-----m---m##-BBBBBBBBBBBBBBB-m----------------m------#####################################
--mmmmmmmmmmmmm---pP--mmmmmmmmm-mmmm---mmmm---pP--mm##pP--------------mmm---m----M--mm-----mm-----mmmmmmk-mmmm--#------mmm###------------------mmmmmmmmmmmmmmmm--------------------------------------------
####################---##-#-#------#---[]-#---pP---###pP---------------#----M--------#------#------##############-------#####-------------------###################----------------------------------------
