------------------------------------------------------------###############################################################################################################################################
-----------------------------------------------------------------------------------------------------------------------------------------------------------------------------------------------------------
-----------------------------------------------------------------------------------------------------------------------------------------------------------------------------------------------------------
--------------------------------------------------------------------------------------------------------------------------------------------------------------------------------------------m--------------
-------------------------------------------------------------------------------------------------------------------------------------------------------mm----------------------------------m-m-------------
--------------------------------------------------------+------------------------------------------------------m-m------------------------------mm----mm----------------------------------mm--m------------
------------------------------------------------------------------------------------BBBBBBBBBB----------------m-m-m-----------------------------mgmmmmm--m-------------------------------m##---m-----------
------------------------------------------------------------------mmm------------mmB--------------------------mg#--m----------------------------m##???----m-----------------------------m###----m----------
-------------------------------mmm-------------------------------m#B-m----------m#Bm--------------------------m##---m--------------------------m###B-------m---------------------------m####-----m---------
------------------mmm---------mm[]mm-??M------------mmm-BBBB----m##---m--------m##--mmmmmmmmmm---------------m###----m------------------------m####---------m-------------------------m#####------m--------
------------mmm--m[]-m-------mm-pP--m--????--------mmh-m---hBB-m###----m------m###--BBBBBBBBB-m-------------m####-----m----------------------m#####----------m-----------------------m######-------m-------
------------mC-m-mpP--m------m--pP---m-------------m-#--m-BBBBm####-----m----m####-------------m------m----m#####------m---m-----m----m-----m######-----------m---m-----m----mmm----m#######V-------m----m-
--mmmmmmmmmm-c--mmpP---mmmmmm---pP----mmmmmmmmmmmmm--#---mmmmm#####------mmmm#####--------------mmmmmm-mmmm######-------mmm-mmmmm-mmmm-mmmmm#######------------mmm-mmmmm-mmmm##-mmmm########[]-------mmmm-m
###################################################################-------#-######---------------#-#-#--#-#######-------#-#---#-#--#-#---#-########------------#-#---#-#--#-#-#--#-#########pP--------#-#--
