--------------------------------------#---------------------------------------------------------------------------------------------------------------[]--#################################################
-----------------------------------------------------------------------------BBB----------------------------------------------------------------------pP---------------------------------------------------
----------------------------------------------------------------------------B-----------------------------------------------mm------------------------pP---------------------------------------------------
--------------------------------------------------------------------------------B-----------------------------------------mmm-m-----------------##----pP---------------------------------------------------
--------------------------------------------------ook-----------------mmmmm--m---BBBBB----------------------------------mm##---m-----------------#######-----------------------------------------mm-m------
----------------------------------------------B*BBBBBBBBB------------m????-m-mm----------------------------------------mm###----m-----------------------------------mmm--------------------------m#m-m-----
--------------------------------------------------------------------m?------m--m---------------------------------------mg###-----m---------------------------------mB?-m------------------------m###--m----
-----------------------------------------------------------mm-------m-------C---m--------------------------------------m####?-----m------------mm----------------mm#----m----------------------m####---m---
------#-t-----------------mmm---------------------h-------m#+mmmmmmmm-------#----m------------------------------------m#####-------m----------mm-m----------------##-----m--------------------m#####----m--
------#BBBBBBBBBBBBBB#---mm[]m-??--------mm-----BBBBBBBB-m####################----m----------m------------m----------m######--------m--------mm---m--------------m##------m------------------m######-----m-
------------------------mm-pP-m--????M?-mm-m------------m###-----------------------m-------mm-mm---------m-mm-------m#######---------mm-m----m-----m------------m###-------m----------------m#######?-----m
------------------------m--pP--m--------m---m----------m####------------------------mmmmmmmgg-k-mmmmmmmmmk-k-mmmmmmm########---------#-m-mmmm-------m-m--------m####--------m-----------m--m########-------
--mmmmmmmmmmmmmmmmmmmmmm---# ---mmmmmmmm-----mmmmmmmmmm#####----------------------#############################################################------mmmmmmmmmm#####---------mmmmmmmmmmm-mm#########-------
########################################------###############----------------------------------------------------------------------------------------M-V#---#-######---------#-#-#-#-#-#--##########-------
