-----------------------------------------###########--------###################---------#------------------------------------------------------------------------------------------------------------------
---------------------------------------------------------------------------------------###-----------------------------------------------------------------------------------------------------------------
---------------------------------------------------------------------------------------pP------------------------------------------------------------------------------------------------------------------
---------------------------------------------------------------------------------------pP------------------------------------------------------------------------------------------------------------------
---------------------------------------------------mmm---------------------------------pP------------------------------------------------------------------------------------------------------------------
---------------------BBBBBBBB?M---------------------?-m--------------------------------pP-----------------??------------------------------------------BBBBBBBB---------------------------------------------
-----------------------------------------##--------m---m-------------------------------pP-----------M---------------------B-----------------------------BBB--------------------------------M---------------
-----------------------------------------#--------m#----m-----------------------m------pP----------?--------------B----------------------------------------------------------------------------------------
-------------------mm-------h-----------##-------m##-----m--------------------mmmm-----##--------------------------BB-------------------------------mm---------B-------------------------------------mm----
------------------mm-mmmBBBBBBB?----mmm--#------m###------m------------------m##--m------#---------------------mm----B-mm--B-----------------------mm-mmmmmmm------mm---BBB-------------------------mm-mmm-
-----------------mm--pP-m--------mm-m#-m-------m####-------m----------------m###---m----------------mm--------mm-m----mm-mmmm---------------------mm---------m----mm-m------------------------------m-----m
-----------------m---pP--m------mmmm-#--m-----m#####--------m-----------m--m###-----m--m----m-------m-m-------m---m---m------m--mm----------------m-----------m---m---m----------------------------m-------
--mmmmmmmmmmmmmmm----pP---mmmmmmm--#-#---mmmmm######---------mmmmmmmmmmm-mm####------mm-mmmm-mmmmmmm---mmmmmmm-----mmm--------mmk-mmmmmmmmmmmmmmmm-------------mmm-----mmmmmmmmmmmmmmmmmmmmmmmmmmmmk-------
############################################-#######-######--#-#-#-#-#-#--#####-------#-##-###################-------#---------###################--------------##------#############################------
