----------------------------#-----#####-----[]#-----------?---------------------------------------------------------################################################------------------------?--------------
-----------------------------##########-----pP----------------##########################----------------------------------------------------------------------------#----------------------mm--------------
---------------------------------#######----pP-----------------------------------------------------------------------------------------------------------------------#-------------------Kmm-m-------------
----------------------------------------#---pP-------------M----------------------------------------------------------------------------------------------------------#-m-----------------m---m------mm----
-----------------------------------------#######-#----V-----------------------------------------------------------------------------------------------------------m----#-mmmmmmmmmmmmmmmmm-----m--K-mm-mmm-
-----------------------mm-------------------------#---[]------------------------------------------------------------------------------------------------------mmmm------######################--m-Kmm-----m
----------------------mm-mmm----mm-----------------###pP-----------------------------------------------------------------m-----------------------------------m####?------------------------------m-m-------
---------------------mm-----m--mm---------------------# ---#--------------------------------------------B---------------m-mm--------------------------------m#####--------------------------------m--------
--------------------mm--------mm--mmm------------------####-------------------------------------------------------------mgg-m------------------------------m######-------------------------------->>-------
--------------------m?-------mm------m-------B-------mm----------------------------------------------mm--BB---mm--------m##--mmmm-------------------------m#######?----------------------------------------
------------------mm---C-----C--------m-------------mm--mm----------------------------?-------------mm-m-----mm-m------m###--BBB-m-----------------------m########-----------------------------------------
------------------mC---c-----c-------t---mmm----mm--m--m----mm-----------------------mm-----m-m-----m---m----m---mmm--m####-------m------------------m--m#########-----------------------------------------
--mmmmmmmmmmmmmmmm-c---c-----c------##-mmmC-m-mmm-mm------mm--mmmmmmmmmmmmmmmmmmmmmmm#-mmmmm-m-mmmmm-----mmmm-------mm#####--------mmmmmmmmmmmmmmmmmm-mm##########-----------------------------------------
##############################-----###--#??--##----#-------#---#-#-#-#-#-#-#-#B-#-#-#---#-##-#-#####------#-#--------######---------#-#-#-#-#-#-#-#-#--###########-----------------------------------------
