----------------------------------------#--#################################------------------------------------------------------------------------------------------------------------#-#######-#########
----------------------------------------------------------------------------------------------------------------------------------------------------------------------------------------##########---------
-----------------------------------------------------------------------------------------------------------------------------------------------------------------------------------------------------------
-----------------------------------------------------------------------------------------------------------------------------------------------------------------------------------------------------------
-----------------------------------------------------mmmm--------------------------------------------------------------------------------------------------------------------------------------------------
------------------BBBBBM??MB-------------------------m##-m----------------------------------------------------------------------------------------------------------------------------------------mm-------
----------------------------------------------------m###?-m------------------------------------------------------------------------------------------------------------------mm-----------------mm--m------
---------------mm----------------------------------m####---m--------------------mm------------------------------------------------------------------------------------------mm-mmm-------------mg#?--m-----
--------------mmVm----h---------------------------m#####----m------------------mm-mmm----------------------mm-----------------------------------------mmmm-----------------mm-----m------------m##----m----
--------------m-[]mmBBBBBBBM?#-------------------m######-----m---------------mmm-----mm------mmm----------mm-mmm--------m----------------------------mm??-m----------------m-------mmm--------m###-----m---
------------mm--pP--m--------?--------mmmm------m#######------m--------------mK------B-m-----m?-m--------mm-----m-----mm-m--------------------------mm-----m---mm-------mmm--------[]-m------m####------m--
------------mC--pP---m----------------m[]-m----m########-------m----m------mm-----------m----m---m-------m-------m----m#--m-------mm------mm--------m-------m--m-m-----Km[]--------pP--m----m#####-------m-
--mmmmmmmmmm-c--pP----mmmmmmmmmmmmmmmm-pP--mmmm#########--------mmmm-mmmmmm##------------mmmm-----mmmmmmm---------mmmm-#---mmmmmmmk-mmmmmmk-mmmmmmmm---------mm---mmmmmm-pP--------##---mmmm######--------m
#########################################---#-##########---------#-#--#-#-#-#-------------#####----######----------######################################-----##############-------------#-#######--------#
