----------------------------------------------------------------------------------------------------------------------------------------------------------------##########-----------------?---------------
-----------------------------------------------------------------------------------------------------------------------------------------------------------------------------------------------------------
---------------------------------------------------------------------------------------------------------------------------------------------------------------------------------###-----------------------
-----------------------------------------------------------------------------------------------------------------------------------------------------------------------------------------------------------
--------------------------------------h--------------------------------------------------------------------------------------------------------------------------------------------------------------------
--------------------------------BBBBBBBBBBBBBBBBB?---------------------------------------------------------------------------------------------------------------------------------------------------------
----------------------------------B-B----------------------------------------------------------------------------------------------------------------------------------------------------------------------
-----------------------------------------------------------------------------------------------------------------------------------------------------------------------mm---------------#---#--------------
------------------------------mm-mmmmmmmmmmmmm-------------------------------------------------mmm------------mmm-----------------------------------------mm----------m#-m--mm-----------###---------------
-----------------------------mm-mB???????BBBB-m------------------------------------------------mM-m----------mm[]mm--------------------------------------mm-mmm------m##--mmmmm----------------------------
----------------------------mm--C--------------m---------mm--------------------mm-------------mmK--m-K------mm-pP--m---????????????M???????????M--------mm-----m----m###--BB---mmm----mm-------mm--------mm
----------------------------m---c---------------m--mm---m#-m----K-------------m#-m------------mB----m------Km--pP---m-----------------------------------m-------m--m####----------m--mm-m----m-m-m-------m#
--mmmmmmmmmmmmmmmmmmmmmmmmmm----B----------------mmh-mmmm#--mmmmmmmmmmmmmmmmmmm#--mmmmmmmmmmmm-------mmmmmmm---pP----mmmmmmmmmmmmmmmmmmmmmmmmmmmmmmmmmmm---------mm#####-----------mmm---m-mm-m---mmmmmmm-#
####################################################################################################-#######################################################------######------------#-----#-###----########
