----------------------------###---------------------------------------------------------------------------------------------------------------------------------------------------------#------------------
-----------------------------------------------------------------------------------------------------------------------------------------------------------------------------------------####-######-------
-----------------------------------------------------------------------------------------------------------------------------------------------------------------------------------------------------------
-----------------------------------------------------------------------------------------------------------------------------------------------------------------------------------------------------------
-------------------------------------------------------------------------------------------------------------------------------------------------------------------------------------mmmm------------------
-------------------------------------------------------------------------------------BBBBBBB----------------------------------------------------------------------------------------mg#?-------------------
-------------------m--------------------------------------------------------------m-------------------------------------------------------------------------------------------------m##--m-----------------
------------------mmm----------BB--------------------------------------------------mmm---------------------------------------------------------------------------------------------m###--------------------
------------------mg-------------BB---------------------------mm------------------mOB-mmmmmmmm----------------------------------mmm-----------------------------------------------m####---m-----------mm---
-----------------m##-m---????--mm--B---------mm-----mm--------m-m------------mmmmm#B-BBBBBBBB-m--------------------------------mm[]mm???--------------------------mmmm-----------m#####----m---------mm-mmm
----------------m###--------??-m-----mm-----mm-m---mm-m----mmm---m----------mm#####------------m-----------------------------Kmm-pP--m--??????????M??????????M---mm[]-m---------m######-----m-------mm-----
---------------m####--m-------mm-m--mm-mmm--m---m--m---m---m[]----m----mm---m######-------------m-----------------------------m--pP---m--------------------------m-pP--m-------m#######------m------m------
--mmmmmmmmmmmmm#####---mmmmmmmmY--mmm-----mm-----mm-----mmm-pP-----mmmmh-mmm-B#####--------------mmmmmmmmmmmmmmmmmmmmmmmmmmmmm---pP----mmmmmmmmmmmmmmmmmmmmmmmmmm--pP---mmmmmmm########-------mmmmmm-------
##############################-y---#-------#------#------################################################################################################################################------#-#-#-------
