--------------------------------##########################--########################-----#---------########################################################################################################
----------------------------------------------------------------------------------##------#--------########################################################################################################
-------------------------------------------------------------------------------------------#-------########################################################################################################
--------------------------------------------------------------------------------------------#------########################################################################################################
---------------------------------------------------------------------------------------mm----#-----########################################################################################################
--------------------m------------------------------------------------------------------m------#----########################################################################################################
---------------------m--m-----------------BBBBBBBBBBBBBBB-------------------------m--mm--m-----#---###############################################################################-------------------------
----------------------mm-m-------------mmB---------------------------------------mmm-m#---m-----####-############################################################################-mmmmmmmmmmmmmmmmmmmmmmmmm
--------------------m--B--m-----------m#Bm-------------m-------------------------m--m------m------#mm#######################-----------------------------------------------------m#########################
-------------------mm------m---------m##B-mmmmmmmmmmmmm-m-----------------------m#-##-------m-----m#--#####################-mmmmmmmmmmmmmmmmmmmmmmmmmmmmmmmmmmmmmmmmmmmmmmmmmmmmm##########################
------------------mmY-------m-------m###--BBBBBBBBBBBBBB-----------------------m##-##--------m---mm-#m---------------------m###############################################################################
------------------m-y--------m-----m####-----------------m-m------------------m##--##---------m--m---#mmmmmmmmmmmmmmmmmmmmm################################################################################
--mmmmmmmmmmmmmmmm--K---------mmmmm#####------------------m-mmmmmmmmmmmmmmmmmm###--##----------mm----######################################################################################################
#####################---------B-#-######---------------h--#--#-#-#-#-#-#-#-#-####--##----#------#----######################################################################################################
