---------------------------###############-----------------?#----------------------------------------------------------------##########################----------------------------------------------------
------------------------------------------#----------------------------------------------------------------------------------------------------------------------------------------------------------------
-------------------------------------------#----k----------------------------------------------------------------------------------------------------------------------------------------------------------
--------------------------------------------#---[]------------------------#--------------------------------------------------------------------------------------------------------------------------------
---------------------------------------------#--pP--------------------------------------------------------------------------------------------------------------#------------------------------------------
---------------------------------------mm-----#-pP-----------------------------------------------------------V--------------------------mmm----------------------------------------------------------------
-----------------------------------MBBmm-m-----###----#------------------------------------------------------[]------------------------mmg-m---------------------------------------------------------------
-------------------------------------mm---m-----######-#-----------------------------------------------------pP-------mmm-m-----------m###--m--------------------------------------------------------------
--------------------mm---------mm----m-----m------------###-#-------mm---------------------------------mmm---pP------mm[]m-m---------m####?--m------------mm------------mm-----------mm--------------------
-------------------mm-mm------mm-mmmm-------m--------------#-------mm-mmm----------mm------mm---------mm[]mm???M??---m-pP---m-------m#####----m----------mm-mmm--------mm-mmm-------mm-mmm-----------------
------------------mm----m----mm----[]--------m--------mm-----M----mm-----m---mm---mm-m----mm-m-------mm-pP--m-----mmm--pP----m-----m######-----m--------mm-----m------mm-----m-----mm-----m-------mmmm-----
------------------m------m---m-----pP---------m--mmm--m-m---------m-------m-mm-m--m---mmm-m---m------m--pP---m----m[]--pP-----mm--m#######------m---m---m-------m-mm--m-------m----m-------m------m[]-m----
--mmmmmmmmmmmmmmmm-B------mmm------pP----------mm---mm---mmmmmmmmm---------mm---mm-------m-----mmmmmm---pP----mmmm-pP--pP-----#-mm########-------mmm-mmm---------mm-mm---------mmmm---------mmmmmm-pP--mmmm
########################---##------pP---k-------##---#----#-#-#######------#-----#-------#----###########################-----#--#########-------#-#---#---------#---##--------K-##----------##############
