--------------------------------------------------------------------------------------------------------------------------------------------------------------------------------------pP-------------------
--------------------------------------------------------------------------------------------------------------------------------------------------------------------------------------pP-------------------
--------------------------------------------------------------------------------------------------------------------------------------------------------------------------------------pP-------------------
--------------------------------------------------------------------------------------------------------------------------------------------------------------------------------------pP-------------------
----------------------------------------------------------------------------------------oh------h-----------------------------mmmm----------------------------------------------------[]m------------------
--------------------------MBBBO-----------------------------------------------------B*BBBBBBBBBBBMBB*?????M???MM-------------m##?-m---------------------------------------------------V-m------------------
---------------------------B---------------------------------------------------------------B--------------------------------m###---m---------------------------------------------mmmmmmm-mm----------------
---------------------------------------------------------------------------------------------------------------------------m####----m-------------------------------------------m#######[]-m---------------
----------------------------------------------------mmm------------------------------------------------------------------mm#####-----m-------------mmm---+---------------------m##----------mmmmmmmmmmmmmmm
----------------O----------m--BBBBBBB???-----------mm[]mm-----------------------------BBBBBBBBBBBBBBBBBBBBBBBBBBB---------######------m-----------mm[]mm--------??????MM?-----m###----------###############
---------------mm---------mVmm----------mmmm------mm-pP--m--???????------------------------------------------------------m######-------m---------mm-pP--m--------?--?--------m####-------------------------
---------------m-m----K---m[]-m---------m[]-m-----m--pP---m-------------mm----------------------------------------------m#######--------m--------m--pP---m------------------m#####-------------------------
--mmmmmmmmmmmmm-B-mmmmmmmmmpP--mmmmmmmmm-c---mmmmm---pP----mmmmmmmmmmmmmh-mmmmmmmmmmmmmmmmmmmmmmmmmmmmmmmmmmmmmmmmmmmmmm########---------mmmmmmmm---pP----mmmmmmmmmmmmmmmmmm######-------------------------
##################################################################################################################################--------########################################----###------------------
