-----------------------------------------------------------------------------------------------------------------------------------------------------------------------------------------------------------
-----------------------------------------------------------------------------------------------------------------------------------------------------------------------------------------------------------
-----------------------------------------------------------------------------------------------------------------------------------------------------------------------------------------------------------
--------------------------------------------------------------------------------------------------------------------------------------------------------------------------m--------------------------------
------------------------------------------------------------------------------------------------------------------------------------------------------------------------mm-m-------------------------------
----------------------------------------------------------------------------------------------------B--------B?--------------------------------------------------------m##B-m-------------------mm---------
------------------------------------------------------------------------------------------------B------BBBB-----------------------------------------------------------m###---m-----------------mm-mmm------
-------------------------------------------------------------------------------------------------BB-------BB---------------------------------------------------------m####----m---------------mm-----m-----
----------------mmm--[]--------------------------------------------------------mmm-----------------B--------B----mm-------------------------------------------------m#####-----m-----------mmmm-------m----
---------------mm[]mm????-----------------------------------------------------mm[]mm-----------mm---B-mm-----B--mm-mmm---------------------------------------------m######------m---------m????--------m---
--------------mm-pP--m--??????M????????????----------------------------------mm-pP--m--?????--mm-m---mm-mmm----mm--[]-m----------mmmm---mmmm----------------------m#######-------m--------m-------------m--
--------------m--pP---mm-----------------------------------------------------m--pP---m--------m---m--m-----m---m---pP--m---------m[]-m--m[]-m------mm------------m########--------m-------m--------------mm
--mmmmmmmmmmmm---pP---k-mmmmmmmmmmmmmmmmmmmmmmmmmmmmmmmmmmmmmmmmmmmmmmmmmmmmm---pP----mmmmmmmm-----mm-------mmm-g--pP---mmmmmmmmm-pP--mm-pP--mmmmmmh-mmmmmmmmmmmm#########---------mmmmmmm#-------------###
##############################################################################################------#--------########----########################################################--###########-------------
