---------------------------------------------------------############################################---###################################################################################################
---------------------------------------------------------B-------------------------------------------------------------------------------------------------------------------------------------------------
-----------------------------------------------------------------------------------------------------------------------------------------------------------------------------------------------------------
-----------------------------------------------------------------------------------------------------------------------------------------------------------------------------------------------------------
-----------------------------------------------------------------------------------------------------------------------------------------------------------------------------------------m-----------------
---------#????M??????M????--------------------------------------------------------------------------------------------------------mmmm-----------------------------------------------mmmm-m----------------
---------#---------------------------------------------------------m-------------------------------------------------------------m##--m--------------------------------------------mm###?--m---------------
---------#--------------------------------------------------------m-m-----------------------------------------------------------m###---m--------------------------------------------####----m--------------
---------#--------------h-------------------------mm--------------mc-m---------------------------------------------------------m####?---m------------------------------------------m####-----m-------------
---------#?MM?M???M????M???----------------------mm-mmm-----------mc#-m-------------------mmmmmmmmmmmmmm----------------------m#####-----m----------------------------------------m#####------m------------
------------------------------------------------mmY----m---------m###--???---------------m###########BB-m--------------------m######------m--------------------------------------m######?------m-----------
------------------------------------------------m-y-----m-------m####--m--------mm------m############----m--------mm--------m#######-------m-------m-----mm------mm----------m--m#######--------m-------m--
--mmmmmmmmmmmmmmmmmmmmmmmmmmmmmmmmmmmmmmmmmmmmmm--#------m-----m#####---mmmmmmmm#-mmmmmm#############-----mmmmmmmm#-mmmmmmmm########--------mmmmmmm-mmmmm#-mmmmmm#-mmmmmmmmmm-mm########---------mmmmmmm-mm
###################################################-------#---#######----#-#-#-#---#-#-##############------#-#-#-#---#-#-#-#########--------#-#-#-#---#-#---#-#-#---#-#-#-#-#--#########---------#-#-#-#--#
