----------------------------------------------#########################------##########------------------######------------------------------################################################--------------
-------------------------------------------------------------------------------------------------------##########------------------------------------------------------------------------------------------
----------------------------------------------------------------------------B------------------------------------------------------------------------------------------------------------------------------
------------------------------------------------------------------------------------------------------------------?----------------------------------------------------------------------------------------
------------------------------------------------------------------------------------------------------------------m---------------------------------------m------------------------------------------------
-----------------------------------------------------------------------------------------------------------------m-m------------------------------------mm-m------------------------------mm---------------
------------------------------------------------------------------------B---------------------------------------m?--m----------------------------------m##--m----------------------------mmgmm-------------
------------------------------------------------------------------------------------mm--B----------------------m?----m------------------mm------------m###---m---------------------------mg#?-m------------
------------------------------mmm----------------------------------------B---------m#-m---------mm------------m#------m----------------mm-mmm--------m####----m--------------------------m##---m----------m
-----------------------------mm[]m-??---------------mmmmmmmmmmmmmmmmmmmmmm--------m##--m-------mm-mmm--------m##-------m--------------mm-----m------m#####-----m------------------------m###----m--------mm
----------------------------mm-pP-m-M???????????---m###################BB-m------m###--Bm-----mm-----m------m###--------m-------------m-------m----m######------m----------------------m####-----m------mm-
----------------------------m--pP--m----------?---m####################----m----m####---Bm----m-------m----m####---------m-----------m---------m--m#######-------m-----------m-----m--m#####------m-----m--
--mmmmmmmmmmmmmmmmmmmmmmmmmm---pP---mmmmmmmmmmmmmm#####################-----mmmm#####-----mmmm---------mmmm#####----------mmmmmmmmmmm#----------mm########--------mmmmmmmmmmm-mmmmm-mm######-------mmmmm---
################################################-######################------#-######------#######------#-######----------B-##########-----------#########--------#-#-#-#-#-#---#-#--#######--------#######
