------------------------------------------------------------------####################################################################################################################---------------------
-----------------------------------------------------------------------------------------------------------------------------------------------------------------------------------------------------------
-----------------------------------------------------------------------------------------------------------------------------------------------------------------------------------------------------------
-----------------------------------------------------------------------------------------------------------------------------------------------------------------------------------------------------------
----------------------------------------------------------------------------------------------------------m------------------------------------------------------------------------------------------------
--------------------------------------------------------------------------------------------------------mm-m-----------------------------------------mmmm------------------------------------------------??
----------------------------------------------------------mm----mm-----------BBB-----------------------m##--m---------------------------------------m##--m-------------------------------------------------
---------------------------------------------------------mm-mm--m-m-----mm--B---B---------------------m###---m-------------------------------------m###---m------------------------------------------------
---------------------------------------------------mm----m----mm---mm--m#-m--------------------------m####----m-----------------------------------m####----m-----------------------------------mmm---------
--------------------------mm----------------------mm-mmmm-----[]-----mm##?-m------------------------m#####-----m---------------------------------m#####?----m---------------------------------mm[]mm---?M??
-----------------mmm-----mC-m-----------Kmm------mm----[]-----pP------###-??mBBB-------------------m######?-----m-------------------------------m######------m-----------------------mm------mm-pP--m----M-
-----------------mC-m----mc--m----------mC-m-----m-----pP-----pP-----####--??m------------mm------m#######-------m---------m-----m----------m--m#######-------m---------mm-----m----mm-m-----m--pP---m-----
--mmmmmmmmmmmmmmm-c--mmmmmC---mmmmmmmmmmmc--mmmmm------c -----c ----#####-----mmmmmmmmmmmm#-mmmmmm########--------mmmmmmmmm-mmmmm-mmmmmmmmmm-mm########--------mmmmmmmmm#-mmmmm-mmmm#-#-mmmmm---pP----mmmmm
################################################################--#######------#-#-#-#-#-#---#-#-#########--------#-#-#-#-#---#-#--#-#-#-#-#--#########--------#-#-#-#-#--#-#-#--#-#--#--##################
