-----------------------------------------######---k######-------------############---------------------------------------------------------------------------------##########----------####################
----------------------------------------------##################-----#############--------------------------------------------------------------------------------###########----------####################
---------------------------------------------------------------#####################--------------------------------------------------??--------------------------############---------####################
---------------------------------------------------------------------------------------------------------------------------------------------------------------------------------------####################
---------------------------------------------------------------------------------------------------------------------------------------------------------------------------------------####################
-------------------------h------------------------------------mm---------------------------------#mm----BBBMBB#---------------------------------------------Bk-------------------------####################
------------------------BBBB----------------BBB---------mm---mm-----------------------------------#-mm------------------------------------mm---------------B-*B------------------------####################
---------------------------BB------------------B---------gmmmm--m--------------mmmmm----------------#-mm---------------------------------mm-m----------------B-------------------------####################
-----------------m-----------------mmm----------------K-m#???----m------------mg###?------------------#-mmmmmmmmmmmmmmmmmmmmmmmmmmmmmmmmmm---m--------------m--------------------------####################
----------------mmm------mmm------mm[]mmmmm------------m##--------m----------m#####---------------------#################################-----m------------m#mm-----------mmm-----mm-----##################
---------------mm--m----KmB------mm-pP-mmm---BB-------m###---------m--------m######------------------------------------------------------------m---mmm----m#-?#mm----------m----mmm-mmm---#################
---------------mC---m---mB--m----m--pP-----m----m----m####----------m------m#######?------------------------------------------------------------m--m#-----m#---#mm--------mghmmmmm-----m-------------------
--mmmmmmmmmmmmm-c----mmmm----mmmm---pP----#-mmmm-mmmm#####-----------mmmmmm########--------------------------------------------------------------mm-#-mmmmm#------mmmmmmmm####BB--------mmmmmmmmmmmmmmmmmmm
##########################----#############--#-#--########------------#############--------------------------------------------------------------############------###########----------###################
