------------------------------------------------------------------------------------------------------------------------------------------------------------------------>##################################
-----------------------------------------------------------------------------------------------------------------------------------------------------------------------------------------------------------
------------------------------------------------------------------------------------------------m----------------------------------------------------------------------------------------------------------
-----------------------------------------------------------------------------------------------m-m---------------------------------------------------------------------------------------------------------
----------------------------------------------------------------------------------------------m?--m--------------------------------------------------------------------------------m-----------------------
-----------------------------mm--------------------------------------------------------------m#----m----------------------------------------------------------------------------mmm-m----------------------
---------------------------mm#-m----------------------------------------------------------mmm##-----m----------mm--------------------------------------------------------------mm##--m---------------------
----------------------------##--m----------------------------------------------------------g###------m--------mm-mmm---------------------------------mm------------------------mg##---m--------------------
---------------------------m##---m-----------mmm------------------------------------------m####-------m------mm-----m-------------------------------mm-mmm---------------------m###----m-------------------
--------------------------m###----m---------mm[]mmM????M------------???M?????????--------m#####--------m-----m-------m-----------------------------mm-----m---------mm--------m####-----m------------------
-------------------------m####-----m-------mm-pP--m---??M------mm-----------------------m######---------mmmmm---------m----------------------------m-------m-------mm-m------m#####------m-----------------
------------------------m#####------m------m--pP---m-----------m-m---------------------m#######---------########-------mmmmmmmmmmmmmmmmmmmmmmmmmmmm---------m--mm--m---m----m######-------m-----------m----
--mmmmmmmmmmmmmmmmmmmmmm######-------mmmmmm---pP----mmmmmmmmmmm---mmmmmmmmmmmmmmmmmmmmm########-#######---------------#################################------mmk-mm-----mmmm#######--------mmmmmmmmmmm-mmmm
#########################################################-#####---##############################--------------------------------------------------------------#####------#-########--------#-#-#-#-#-#--#-#
