-----------------------------------------------------------------#----------######-----------------------------------------------------------------------------------------------------------#-------------
-----------------------------------------------------------------------------##################------------------------------------------------------------------------------------------------------------
-----------------------------------------------------------------------------------------------------------------------------------------------------------------------------------------------------------
-----------------------------------------------------------------------------------------------------------------------------------------------------------------------------------------------------------
-----------------------------------------------------------------------------------------------------------------------------------------------------------------------------------------------------------
-----------------------------------------------------------------------------------------------------------------------------------------------------------------------------------------------------------
-----------------------------------------------------------------mmm---------------------------------------------------------------------------------------------------------------------------------------
----------------------------------------------------------------mmm-mmm------------------------------------------------------------------------------------------------------------------------------------
----------------------------------------------------------------m-c----m----------mm---------------------------------mm------------mm----------------------------------------------------------------------
-------------------------------------mmm-----------------------m--c-----m----#---m#-m-------------------------------mm-mmm--------mm-mmmm--mm------mm-----mm-----------------------------mm-----mm--------m
-------------mmm---------------------mC-m-------------mmm-----mC--c------m------m##--------------------------------mm-----m------mm------m-mmm----mm-m---mm-m---------------------------mm-m---mm-m------mm
-------------mC-m---------------K----mpP-m------------mC-m----m#--#-------m----m###--m------------m---------mm-m---m-------m-----m--------m---m---m---m--m---m-----mm-----mm------------m---m--m---m-----m-
--mmmmmmmmmmm-c--mmmmmmmmmmmmmmmmmmmm-c---mmmmmmmmmmmm-c--mmmmmC-----------mmmm####---mmmmmmmmmmmm-mmmmmmmmm#-m-mmm---------mmmmm---------#----mmm-----mm-----mmmmmk-mmmmm#-mmmmmmmmmmmm-----mm-----mmmmm--
################################################################--c---------#-#####---##-#-#-#-#-#--#######################--##########---#-----##------#------#########################------#------######
