--------------------------------########-######################################----------------------------------#----#####################################################################################
----------------------------------------------------------------------------------------------##########---------#-----------------------------------------------------------------------------------------
-----------------------------------------------------------------------------------------------------------------#-----------------------------------------------------------------------------------------
-----------------------------------------------------------------------------------------------------------------#-----------------------------------------------------------------------------------------
-------------------------------------------------------------------------------mm------------------------->------#-----------------------------------------------------------------------------------------
---------------------------------------------------m--------------------------mB-m-------------------------#######----------------------------------------------mmmmm-----------------------------------mmm
--------------------------------------------------m#mm-----------------------m#---m-----------------------------####---------mmmmmmm---------------------------mg##--m---------------------------------m###
-------------------------------------------------m##?-m---------------------m##----m----------------------------------------mBBBBBM-m-------------------------mg###---m--------------------------------m###
-------------------------------B----------------m###---m-------------------m###-----m--------mm----------------mm----------m#--------m------------------------m####----m------------------------------m####
-------------------------------MBB-------------m####----m-----------------m####------m------mm-mmm-------mm---mm----------m##---------m----------------------m#####-----m----------------------------m#####
-----------------------mmmm---mm--------------m#####-----m---------------m#####-------m----mm-----m-----mm-m--m--m-------m###----------m--------------------m######------m--------------------------m######
-----------------------m[]-m--mBm------------m######------m--------m----m######--------m---m-------m----m---mm----m--m--m####-----------m------m--------m--m#######V------m----------m----m-----m--m#######
--mmmmmmmmmmmmmmmmmmmmm-pP--mm---mmmmmmmmmmmm#######-------mmmmmmmm-mmmm#######---------mmm---------mmmm-----M-----mm-mm#####------------mmmmmm-mmmmmmmm-mm########[]------mmmmmmmmmm-mmmm-mmmmm-mm########
#########################################-#-########--------#-#-#-#--#-########-#############--------#-#----------#-#--######-------------#-#-#--#-#-#-#--#########pP-------#-#-#-#-#--#-#---#-#--#########
