------------------------------------------------------#-----###############################################################------------------------------------------------##############---###############
-------------------------------------------------------#---------------------------------------------------------------------------------------------------##----------------------------------------------
-----------------------------------------------------------------------------------------------------------------------------------------------------------------------------------------------------------
-----------------------------------------------------------------------------------------------------------------------------------------------------------------------------------------------------------
----------------------------------------------------------------------------K------------------------------------------------------------------------------------------------------------------------------
-------#???M??-----------------------------------------------------------mmmm----------------------------------------------mmmm-----------------------------------------------------mm---------------------
-------#----------------------------------------------------------------m###-m-------------------mm-----------------------m#?--m---#-----------------------------------------------m#-m--------------------
-------#---------------------------------------------------------------m####--m-----------------m#-m---------------------m##----m-------------------------------------------------m##--m------#------------
-------#k---k-------------------------------------mmmmmm--------------m#####---m---------------m##--m-------------------m###-----m--##---------------mm--------------------------m###---m------------------
-------#?M?M??M??????????????????????------------m####BBmm-----------m######----m-------------m###---m-----------------m####------m-----------------mm-mmm-------mm-----mm------m####?---m----------------m
------------------------------------------------m#####--B-m---------m#######V----m-----------m####----m---------------m#####-------m-----mm--------mm-----m-----mm-m---mm-m----m#####-----m--------------m#
-----------------------------------------------m######-----m---mm--m########[]----m----m----m#####-----m----m--------m######--------m----m-m-------m-------m----m---m--m---m--m######------m----m----m--m##
--mmmmmmmmmmmmmmmmmmmmmmmmmmmmmmmmmmmmmmmmmmmmm#######------mmm#-mm#########pP-----mmmm-mmmm######------mmmm-mmmmmmmm#######---------mmmm---mmmmmmm---------mmmm-----mm-----mm#######-------mmmm-mmmm-mm###
#######################################################------##---##########pP------#-#--#-#######-------#-#--#-#-#-#######-##-------#-##---########---------#-#------#------########--------#-#--#-#--####
