---------------------------------------------------------------------------------------------------------------------##########--------------------------##################################################
-----------------------------------------------------------------------------------------------#-----------------------------------------------------------------------------------------------------------
-----------------------------------------------------------------------------------------------##----------------------------------------------------------------------------------------------------------
-----------------------------------------------------------------------------------------------------------------------------------------------------------------------------------------------------------
------------------------------------------------------------------------------------------------------------------------------m---------------------------------------------------m------------------------
----------------------------------BBBBBBBBB----------------------------------------------------------------------------------m-m------------------------------------------------mm-m-----------------------
----------------------------m-----------------------------------------------------------------------------------------------mg--m----------------------------------------------m##--m----------------------
-----------------------------mmmmm------------------------------------------------------------------------------------------mg---m-------------mmm----------------------------m###---m---------------------
--------------------------mmm###BBmmmmmmmmmm----------------------------------------------mmm---------------mm------------mm##----m-----------mm[]mm-------------------------m####----m--------------------
-------------------------m######--BBBBBBBBB-m--------------------------------------------KmK-mK-----m------mm-mmm----#---mg###-----m---------mm-pP--m---??------------------m#####-----m-------------------
------------------------m#######-------------m-------m--------m-------------------------mm----m----mmm----mm-----m-------m####------m--------m--pP---m----?----------------m######?-----m------------------
-----------------------m########--------------m-----mmm------mmm--------------K--K------mK-----m--mm--mmm-m-------m-----m#####-------mmmmmmmm---pP----mmm------------mmm--m#######-------m---m----m----m--m
--mmmmmmmmmmmmmmmmmmmmm#########---------------mmmmmm--mmmmmmm--mmmmmmmmmmmmmmmmmmmmmmmm--------mmmKK----m---------mmmmm######-------####################mmmmmmmmmmmm##-mm########--------mmm-mmmm-mmmm-mm-
##########################################################################################-----K-#?------#----------#-########----------------------------#-#-#-#-#-#-#--#########--------#-#--#-#--#-#--#-
