-------------------------------------------------------------------------------------#--#######pP----------------------------------------------------------------------------------------------------------
-------------------------------------------------------------------------------------############------------------------------------#########-------------------------------------------------------------
-----------------------------------------------------------------------------------------------------------------------------------------------------------------------------------------------------------
-----------------------------------------------------------------------------------------------------------------------------------------------------------------------------------------------------------
------------------------------------------------------------------------------------------------mm---------------------------------------------------------------------------------------------------------
-----------------------------------------------------------------------------------------------mm-m------------------------------------------------------------------------------------M-------------------
----------------------------------------M------------------------------------------------------m#--m--#--------------------------BB------------------------------------------------------------------------
-----------------------------------------------------------------------------------------------m#---m--##--------------------------BB----------------------------------------------------------------------
------------------------------------------------mmm-----------------------------mm------------m##----m-----------------------mmmmm---B---------------------------------------------------------------------
----------------------------------------mm-----mm[]m-??------------------------mm-mmm--------m###-----m---------------------mm[]--m------------------???????M??--------------------------------------------
---------------------------------mmm---m#-m---mm-pP-m--??????????????---------mmY----m------m####------m-------------------mm-pP---m-----------------------------------------------------------------------
---------------------------------mC-m--m#--m--m--pP--m------------------------m-y-----mm---m#####-------m-m------mm-m------m--pP----m------------mm----mm--------------mm----mmm---mm----------mm----------
--mmmmmmmmmmmmmmmmmmmmmmmmmmmmmmm-c--mmm#---mm---pP---mmmmmmmmmmmmmmmmmmmmmmmm--#-----#-mmm######--------m-mmmmmm#-m-mmmmmm---pP-----mmmmmmmmmmmmk-mmmmk-mmmmmmmmmmmmmmk-mmmmkg-mmmk-mmmmmmmmmmk-mmmmmmmmmm
#################################################################################-----#-#########--------#--####################------#-#-#-#-#-###########################################################
