----------------------------------B##########################################################---------------------------------------K##########------------------------------------------------------######
-----------------------------------------------------------------------------------------------------------------------------------------------------------------------------------------------------------
------------------------------------------------------------------------------------------------------------------------------------------------m----------------------------------------------------------
-------------------------------------------------------------------------------------------------------------------------------------------------m---------------------------------------------------------
----------------------------------------------------------------------------------------------mm-----------------------------------------------m--m--------------------------------------------------------
---------------------------------------------------------------------------------------------mm-mmm-----------------------------------------mmm?---m-------------------------------------------------------
----------------------------------------------------------------------------------------mmmmmm-----m-----------------------------------------##-----m------------------------------------------------------
------------------m----------------------------------------mm--------------------------m#????-------m---------------------------------------m##------m-------------------------------------mm-------------m
-----------------mmmmmmmmmmmm-----------------------------m#-m------------------------m##------------m---------mm--------------------------m###-------m------mmm--------------------------mm-mmm--m-------m
-----------------mg#####BBBB-mmm-------------------------m##-------------------------m###-------------m-------mm-mmm-----mm-----mm--------m####--------m----mmm-m--------------------mmm--m-----mm-m------m
----------------m#######-----MK-m-----------------------m###--m---------------------m####--------------m-----mm-----m---mm-m---mm-m------m#####?--------m---m----m------------------mmm-mm------>>--m----m#
---------------m########---------m--------mmm----------m####-------------------mm--m#####---------------m----m-------m--m---m--m---m----m######----------mmm------m-----------------m-Y--K-----------m--m##
--mmmmmmmmmmmmm#########----------mmmmmmmm##-mmmmmmmmmm#####---mmmmmmmmmmmmmmmm#-mm######----------------mmmm---------mm-----mm-----mmmm#######-------#########----mmmmmmmmmmmmmmmmm--y---------------mm###
#########################--------B-#-#-#-#-#--k-#-#-#-######----#-#-#-#-#-#-#-#---#######----------------K-##----------#------#------#-########-#-------------------###################----------------####
