--------------------------------------------------------------------------------------------------------------------------------------------------------------------------------------------------------###
-----------------------------------------------------------------------------------------------------------------------------B----------------------------------------------------------------------###----
--------------------------------------------------------------------------------------------------------------------------BBpP---------------------------------------------mmm-----------------------------
----------------------------------------------------------------------------------------------------------------------------pPBBM--------V--------------------------BBB---m#?-m----------------------------
--------------------------------------------------------------------------------------------------------------BB-------mmmm-pP-----------[]------------------------------m##---m---------------------------
----------------------------BBBBBBBBBBBBBBBBB-------------------------------------------------------------------------mm[]-mB------------pP-----------------------------m###----m--------------------------
---------------------------------------------------------------------------------------------------------------------mm-pP--m-------mmm--pP---------------------mmmmmmmm####-----m-------------mm----------
---------------------------m-------------------------------------------------------------------------------------m---m--pP---m-----mm[]mm???---------B----------m###########------m-----------mm-mmm-------
--------------------------mhmmmmmmmmmmmmmm------------------mmm-----------------------------------------mm-mmmmmm-mmm---pP----m---mm-pP--m-------mmmm--------mmm-###########-------m---------mm-----m------
-------------------------mmBBBBBBBBBBBBBB-m--------mm------mm[]mm--------------------------------------mm-m----##-########-----m--m--pP----mm----m[]-m---mm--m[]-###########--------mm-m-----m-------m-----
--------------mmm-------mmB----------------m------m#-m----mm-pP--m--????M???M????M?????M????M---------mmY-B---------------------mm---pP---mk-mmmm-pP--mmmh-mm-pP-###########--------#-m-mmmmm---------m----
--------------m#-m------m-------------------m-K---m#--m---m--pP---m-----------------------------------m-y--------------------###################################################################-------m---
--mmmmmmmmmmmm-#--mmmmmm---------------------mmmmmm#---mmm---pP----mmmmmmmmmmmmmmmmmmmmmmmmmmmmmmmmmmm--------------------------------------------------------------------------------------------------mmm
#########################################################################################################------------------------------------------------------------------------------------------------#-
