---------------------------------------##############----------------------------####---------------------------------?------------------->####------------>#########--------------------------------------
-----------------------------------------------------##################----------####-----------------------------------------------------------------------------------------#########--------------------
--------------------------------------------------------------------------------#####V---------------------------------------------------------------------------------------------------------------------
--------------------------------------------------------------------------------#####[]--------------------------------------------------------------------------------------------------------------------
-----------------------------------------------------------------------------#-######pP----------------------------#-------------------------------------------------mm------------------------------------
----------------------BBBBBBB-------------------------------------------------#############-------------------------#-----------------------------------------------m--m-----------------------------------
------------------------B----------------#---------------------------------------------------------------------------#--------------------------------------------mm#?--m----------------------------------
--------------------------------mm-------#--------mm------------------------------------------------------------------##-------------------------------------------k#----m---------------------------------
--------------------mmmm-------mm-mmm-------------mgmmm------------------mm---------------------------------mm--------------------------------------mm------------m##-----m--------------mm----------------
---------------------m+?m-BBBB-m-----m------------mg#O-m----------------mm-mmm------mmmm-----mm------------mm-mmm---------?-m----------------------mm-mmm--------m###------m------------mm-mmm-----------mm
------------mmm--K--m#---m----m-------m---k------m###---m--------------mm-----m----mg#--m---mm-mmm---mm---mm-----m---------m-m---mm----mm---------mm-----m------m####-------m----------mm-----m---mmm---mm-
------------mC-m----m#--------m--------m------mmm####----m?-------m----m-------m--m###---m--m-----m--m-m--m-------m--m--m--m--m--m-m---m-m----mm--m-------m----m#####--------m----m----m-------m--mY-m--m--
--mmmmmmmmmm-C--mmmm-#----mmmmm---------mmmmmm#######-----mmmmmmmm-mmmm---------mm####----mm-------mm---mm---------mmmmm-mm----mm---mmm---mmmm#-mm---------mmmm######---------mmmm-mmmm---------mm-y--mm---
###############################---------#-##-#-######------#-#-#-#--#-#----------#####-----#--------#----#----------#--#--#-----#----##----#-#---##---------#-#######-######---#-#--#-#----------###-->>---
