-----------------------------------#-----------------------------------------------------------------------------------------------------------------------------------------------------------------------
-----------------------------------------------------------------------------------------------------------------------------------------------------------------------------------------------------------
-----------------------------------------------------------------------------------------------------------------------------------------------------------------------------------------------------------
-----------------l-------------------------------------------------------------------------------------------------------------------------------------------------------mm--------------------------------
---------------------------------------------------------h---------------------------------------------------------------------------------------------------mmm--------mm-mmm-----------------------------
-------------------+------------------BBBBBBBBBBBBBBBBB?BBBB--------------------------------------------------------------------------------------------------#-m------mm-----m----------------------------
-----------------------------------Vm------------------------------------Kmm-----------------------V---------------------------------------------------------m#--m-----m-------m---------------------------
-----------------------------------[]m-----------------------------------m#-m----------------------[]-------------------------------------------------------m##---mmmmm---------m--------------------------
------------------------------mmm--pPgmmmmmmmmmmmmmmmmmmmmm--------------m#--m----------------mmm--pP--------------------------------------------m---------m###---#########------m-------------------------
-------------------mmm-------mm[]mm????M??????????????????-m------------m##---m--------------mm[]mm??M????M---------?------------MM--------------mmm------m####-------------------m------------------------
------------mmmm--m[]-m-----mm-pP--m------------------------m---------mm###----m-----------Kmm-pP--m---?????????????-------------------mmmm----mm-?-mmmmmm#####--------------------m---mm---mm------------m
------------m[]-m-mpP--m----m-KpP----------------------------m-------m#####-----m-----------m--pP------------------mm---mm-------mm----m[]-m---m#---###########------------------#--mmmk-mmmk-mmmmmmmmmmmmk
--mmmmmmmmmm-pP--mmpP---mmmm---pP---k-------------------------mmmmmmmm#####------mmmmmmmmmmm---pP---mmmmmmmmmmmmmmmk-mmmk-mmmmmmmk-mmmm-pP--mmm-#--------------------------------##########################
####################################################################################################################################[]#############--------------------------------------------------------
