---------------------------------------------##----------c----####################################################################-------------------------------------------------------------------------
-----------------------------------------------------#####-------------------------------------------------------------------------------------------------------------------------------------------------
----------------------------------------------------------#------------------------------------------------------------------------------------------------------------------------------------------------
----------------------------------------------------------------------------------------------------------------------------------------------------------------------------------------------------mm---m-
----------------------------------------h---------------------------------m------------------------------------------------------------------------------------------------------------------------mm-mmmmm
-----------------------------------M-BBBBBBBBBB----B--------------------mm-m-------------------------------------------------------m-----------------------------------mm---mm--------------------mm----K--
------------------------------------?---------BB-----------------------m##--m-----------------------------------------------------mmm---------------------------------mm-m--m-m--------------mm---m--------
------------------------------------------------B---------------------m###---m---------------------------------------------------m#--m--------------------------------m---mm---m------------mm-mmm---------
-------------------------------------mmmmmmmmmm--B----mm-------------m####----m-------------------------------------------------m####-mmmmmmmmmmmmmmmmmmmmmmmmmmmmmmmm-----K----m----------mm---##---------
------------------------------------m??????????m--BB-mm-mm----------m#####-----m-----------------------------------------------m#----#################################-----------m--m------m---------------
---------------------mmm-----------mC-----------m---mm----mm-------m######------m---------------------------------------------m##-------------------------------------------------mm-m---mm----------------
---------------------mC-m----------mC------------m--m-----C-------m#######-------m-----m----------m----------mm--------------m###------------------------------------------------->>--m--m#----------------
--mmmmmmmmmmmmmmmmmmm-c--mmmmmmmmmmmc-------------mm------C-mmmmmm########--------mmmmm-mmmmmmmmmm-mmmmmmmmmm#-mmmmmmmmmmmmmm####------------------------------------------------------mm-#----------------
###############################################----#------c--#-#-#########--------#-#-#--#-#-#-#-#--#-#-#-#-#---#-#-#-#-#-#-#####------------------------------------------------------>###----------------
