-----------------------------#############------------[]---------------------------------------------------------------------------------------------------------------------------------------------------
------------------------------------------------------pP---------------------------------------------------------------------------------------------------------------------------------------------------
------------------------------------------------------##--------------------------------------------------------------------------------------------------------------------------------------------------#
--------------------------------------------mm-------------------------------------------------------------------------------------------------------------------------------------------------------------
-------------------------------------------mm-mmm----------------------------------------------------------------------------------------------------------------------------------------------------------
-------------------------------------------m-----m----------------------------------------------------?BBBB------------------------------------------------------------------------------------------------
--------------------------------------mmmmm-------m-----------------------------------------------------------------------------------------------------------mm---mm--------------------------------------
-------------------------------------m##??B--------m------------------------------------------------mmm---m--------------------------------------mm---mm-----mm-mmmm-m-------mm------------mmm-----------mm
---------------------mmm------------m###------------m--------mm----------mm-------------------------m?-mmm-m--------------mm----mm-----mm-------mm-mmmm-m---mm----K---m-----mm-mmm--------mm#-mmmmmmmmmmm#-
--------------------mm[]-mM?B?-----m####-------------m------mm-mmm------mm----------mm------------mm-M???B--m------------mm-mmmmm-m--mmm-mmm---mm----K---m--m----------m---mm-----m-------m---#############
-------------------mm-pPm-m-?M?---m#####--------------m----mm-----m----mm--m-------mm-m----mm-----mK---------m----------mm-----m---m-mm-----mm-m----------mm------------mm-m-------m---mmm-----------------
-------------------m--pP---m-----m######---------------m---m-------m---m----mmm----m---mm--m-m----m-----------m---m-----m-----------m-------#-m-----------##------------#-m---------m--m>#-----------------
--mmmmmmmmmmmmmmmmm---pP----mmmmm#######----------------mmm---------mmm--------mmmm------mm---mmmm-------------mmm-mmmmm------------#---------#-------------------------#-#----------mm--------------------
########################-######-########---------------V#-#--------########---->>-#-------################------##-########---------#---------#---------------------------------------#--------------------
