--------------------------------?----#########---------------------------------------------------------------------#-----------############################################################################
--------------------------------B-------------#------------------------------------------------------------------mm-#----------############################################################################
--------------------------------#--------------#----------------------------------------------------------------mm---#--#------############################################################################
---------------------------------------------------------------------------------------------------------------mm--m--#-#-----#############################################################################
-------------------------------------------------------------------------------------------------------------m-m-------##------############################################################################
------------------------------------------------------------------------------------------------------------m-m-----m---###----############################################################################
---------------------------------------------BB-------------------------------------------------------------mg#------m--------#############################################################################
----------------------------m--------------mmm-B------------------------------------------------------------m##---------------#############################################################################
---------------------------mmm------------m#B---B-------------mm----------mmmm---------------mm------------m###-------m-------#############################################################################
-------------------------mmm-------------m##?-m--B-----------mm-mmm------mm[]-m-??---?------mm-mmm--------m####---------------------######################pP############################pP#################
-----------------mmm----m-mY--m---------m###-??m------------mm-----m----mm-pP--m--???------mm-----m------m#####--------m----mm-------######################################################################
-----------------mC-m--mmm-y---m-------m####---?m-----------m-------m---m--pP---m----mm----m-------mmmmmm######-------------m-m----------------------------------------------------------------------------
--mmmmmmmmmmmmmmm-c--mmm---#----mmmmmmm#####----?mmmmmmmmmmm---------mmm---pP----mmmmk-mmmm-------#################-----mmmm---mmmmmmmmmmmmmmmmmmmmmmmmmmmmmmmmmmmmmmmmmmmmmmmmmmmmmmmmmmmmmmmmmmmmmmmmmmmm
############################-----#?-#-#-####-----B-#-##########-------########################---------------------#-----#-#---############################################################################
