--------------------------------------------------------#####################################----------------------------########--------------------------------------------------------------############
---------------------------------------------------------------------------------------------#-------------------------------------------------------------------------------------------------------------
--------------------------------------------------------------------------------------------m-#------------------------------------------------------------------------------------------------------------
-------------------------------------------------------------------------------------------mmm-#-----------------------------------------------------------------------------------------------------------
-----------------------------------------------------------------------------------------mmm----#----------------------------------------------------------------------------------------------------------
--------------------------BBBBBBBBBBBBBBBB----------------------------------------------mmm---m--#------------------------------------------------------------------------------------------------------mmm
----------------------------------------------------------------------------------------mg--------##---------------------------------------------------------------------------------------------------m###
---------------------------------------------------------------------------------------m##-----m----####-#--#------------------------------------------------------------------mm---------mm---------K-m###
--------------------------mmmmmmmmmmmmmmm-------mmm-----------------------------------m###----------------###------mm------------mmm--------------------------------------mm---m-m-------mm-m---------m####
------------------------mmBBBBBBBBBBBBBB-m-----mm[]mm--------------mmm---------------m####------m-----------------mm-mmm--------m#B-m---------------------mm-----mm------mm-mmm---m-mm---m---m-------m#####
---------------mmm-----mmB----------------m---mm-pP--m--??????----mm[]mm------------m#####---------mm---mm-------mm-----m------m##---m-------------------mm-m---mm-m----mm----B----mk-mmm-----m-----m######
---------------mC-m----m-------------------m-Km--pP---m-----------m-pP--m----------m######V------m-m-m--m-m--mm--m-------m----m###----m------------------m---m--m---mm--m----------######------m---m#######
--mmmmmmmmmmmmm-c--mmmm---------------------mm---pP----mmmmmmmmmmm--pP---mmmmmmmmmm#######[]------m---mm---mmm-mm---------mmmm####-----mmmmmmmmmmmmmmmmmm-----mm------mm------------------------mmm########
##########################################################-#-#-#-#--pP----#-#-#-#-########pP------#----#----#---#----------#-#####----BBB-###############----->>-------#------------------------#-#########
