------------------------------#--????------------------------------------------------------?-----------------------------------------------------------B-----------------------------------################
-------------------------------#-[]???-V----##---------------K-----------------------------m---------------------------------------------------------------------------------------------mm----------------
--------------------------------#pP--?-[]-------------------------------------------mm---mm-m--------------------------------------------------------------------------------------------m-----------------
---------------------------------#k---?pP----------------mmmmmmmmmmm---------------mm-mmm?M--m------------------------------------------------------------------------------------------mm-mm--------------
----------------------------------#----? ---------------m#BBBBBBBBM-m-------------mm----B--------------------------------------------------------------mm-----------------------------Mmm----m-------------
-----------------------------------##mmm?M????M?-------m##-----------m------------m-----------mm------------------------------------------------------mm-mmm--------------------------m?------m------------
---------------------------m---------#k---------------m###------------m---------mm------------C-m--------mmm---------------------------mmm-----------mmY----m-------------------------m--------m-----------
--------------------------mgm---------#--------------m####-------------m--------mC------------c--m-------mC-m-------------mm-----------mC-m----------m-y-----m-----------------------mC---------m----------
--------------------------mC-mmm-------#mmmmmmmmmmmmm#####--------------mmmmmmmm-c------------c---mmmmmmm-c--mmmmmmmmmmmmmh-mmmmmmmmmmm-c--mmmmmmmmmm--K------m----mmmm--------------mc----------m---------
--------------------------m###O---------##############################--################################################################################-------m---m[]-m------------m??-----------m--------
-------------------mmmmmmm####--m-------------------------------------------------------------------------------------------------------------------------------mmm-pP--m-----------m------Y-------m-------
-------------------m##########------??--------------------------------------------------------------------------------------------------------------------------######---m----------m-----#y--------m------
--mmmmmmmmmmmmmmmmm-#-########---mmmm-?-----------------------------------------------------------------------------------------------------------------------------------mmmmmmmmmm-------#---------mmmmmm
###############################---#?#--?--------------------------------------------------------------------------------------------------------------------------------####################----------#-#-#
