-----------------------#----------------------------------------#----------------->----pP-----pP--[]---##--------------------------------------------------------------------------------------------------
------------------------#----------------------------------------------------------############ --pP---##--------------------------------------------------------------------------------------------------
-------------------------#--------------------------------------------------------------------##--pP---##--------------------------------------------------------------------------------------------------
--------------------------#-----------------------------------------------------------------------####-##--------------------------------------------------------------------------------------------------
---------------------------#######---------------------------------------------------------------------##-----------------------------------------------B--------------------------------------------------
------------------mmm-mm--------------------------------------------------------------------------------#-----------------------------------------------m-BB-----------------------------------------------
-----------------mmggmmmm--------------------------------------------------------------------------------------------------------------------------------B--B----------------------------------------------
-----------------mgg#?----------------------------------------------mm-----------mm----------------------------------------------------------------------m-------------------------------------------------
-----------------m###----m----mm--------------------------------m-mmm-mmm-------mm-mmm-----mm-----------------------------------------------------------m-m----------------mmm-----------------------------
----------------m####-----mo-mm-m------mm-----------------------mmmm-----m-----mm-----m---mm-m---------------mm-----mm------mm------mm-----mm-----------m--m------mm------mm[]mm---------------------------
---------------m#####------m-m---mm---mm-m----mm--------------mm-K--------m----m-------m--m---m---mm--------mm-m---mm-m----mm-m----mm-m---mm-m---------mm---m----mm-m----mm-pP--m--????????MM??????M????M--
--------------m######-------m----M-m--m---m---m-m-------------m#-----------mmmm---------mm-------mm-m--m----m---m--m---mm--m---m---m---m--m---m--------mY----m---m---m---m--pP---m-------------------------
--mmmmmmmmmmmm#######-------M-------mm-----mmm---mmmmmmmmmmmmm-#-----------######-------[]-----mmm---mmmmmmm-----mm------mm-----mmm-----mm-----mmmmmmmm-y-----mmm-----mmm---pP----mmmmmmmmmmmmmmmmmmmmmmmmm
########################-------------#------##----###############-----------------------pP-----[]--V--#-##-#------#-------#------##------#------#########------##------####################################
