------------------------------------------------------------------------------------#---------#------------------------------------------------------------------------------------------------------------
-------------------------------------------------------------------------------------#############---------------------------------------------------------------------------------------------------------
-----------------------------------------------------------------------------mm----mm----------------------------------------------------------------------------------------------------------------------
-----------------------------------------------------------------------------mgmmmmm-m---------------------------------------------------------------------------------------------------------------------
----------------------------------------------------------------------------m###m-m---m--------------------------------------------------------------------------------------------------------------------
--------------------------------------------------------------------------mm####-------m-------------------------------------------------------------------------------------------------------------------
---------------------------------------------------------------------------#####--------m---------------#--------------------------------------------------------------------------------------------------
--------------------------------------------------------------------------m#####?--------m---------------#-------------------------------------------------------------------------------------------------
---------------------mmmmmmmmmmmmmmmmmmmmmmmmmmmmmmmmmmmmmmmmmmmmmmmmmmmmm######?---------m-------------#-------------------------------------------------------------------------------------mm-----------
--------------------m###########################################################-----------m-------mm-----------mm-----------mm-----mm-----mm---------------mm-----mm----------mm-----mm-----mm-mmm-----mm-
-------------------m############################################################------------m-----mm-mmm--mm---mm-m---mm----mm-m---mm-m---mm-m---mm---mm---mm-m---mm-m---mm---mm-m---mm-m---mm-----m---mm-m
------------------m#############################################################-------------m----m-----m-m-m--m---m--m-m---m---m--m---m--m---m--m-m--m-m--m---m--m---m--m-m--m---m--m---m--m-------m--m---
--mmmmmmmmmmmmmmmm#######-#######################################################-------------mmmm-------m---mm-----mm---mmm-----mm-----mm-----mm---mm---mm-----mm-----mm---mm-----mm-----mm---------mm----
##########################-------------------------------------------------------####----------#-#-------#----#------#----#>------#------#------#----#----#------#------#----#----->>------#----------#----
