------------------------#######-----------------------------------------------------------pP--#####################################################################################--####################--
------------------------------------------------------------------------------------------pP---------------------------------------------------------------------------------------------------------------
------------------------------------------------------------------------------------------##---------------------------------------------------------------------------------------------------------------
----------------------------------------------------------------------------------------------------------------------------------------------------------------------------------------------------------m
----------------------------------------------------------------------------------------------------------------m----------------------------------------------------------------------------------------m-
--------------------------------------------------------m-----------------------------------------------------mm-m-----------------------------------mmmm----------------------------------------------mm--
-------------------------------B-----------M-----------m--------------------------------B--------------------m##B-m----------------------------------m-#Vmm-------------------------------------------m##?-
-------------------------mm----------------------------mgmm-------------------------------------------------m###---m--------------------------------m-##[]-m-----------------------------------------m###--
-----------------------mmm-mmm-------------------------mc#-m----------?--------------mmmmBB----------------m####----m-------------------------------m-##pP--m---------------------------------------m####--
-----------------------mm-----m------------mm---------m###--?---BBBB??-?-?----------mm[]-m----------------m#####-----m------------------------------mg##pP---m-------------------------------------m#####--
---------------------mm-?-----------------m#-m-------m####--m-----------?----------mm-pP--m---?----------m######------m----------------------------m####pP----m-----------------------------------m######--
---------------------m#----B---m----------m#--m-----m#####---m---------------------m--pP---m------mmmm--m#######-------m----------m--------m----mmm#####pP-----m---m----m----m----m-m----m----m--m#######--
--mmmmmmmmmmmmmmmmmmm-#--------Ymmmmmmmmmmm#---mmmmm######----mmmmmmmmmmmmmmmmmmmmm---pP---Vmmmmmm#[]-mm########--------mmmmmmmmmm-mmmmmmmm-mmmm########pP------mmm-mmmm-mmmm-mmmm-m-mmmm-mmmm-mm########--
#########################------y########################################################---[]-##-#-pP--#########---------#-#-#-#-#--#-#-#-#----#-#######pP------#-#--#-#--#-#--#-#-#--#-#--#-#--#########--
