----------------------------------------------------------------------------------------------------------########------y---------------------------------------------------#--############################
-------------------------------------------------------------------------------------------------------------------######-----------------------------------------------------m---------------------#######
--------------------------------------------------------------------------------------------------h-------------------------------------------------------------------------mm-----------------------######
------------------------------------------------------------------------------------------------BBBB-----------------------------------------------------------------------m-k-m----------------------#####
-------------------------------------------------------------------------------------------------m--B----------------------------------------------------------------------m-#--m-----------------mmmm-####
-------------------------------------------------------------------------------mm---------------m----B----B----------------------------------------------------------------m-#---m---------------mg###m-###
------------------------------------------------------------------------------mm-m-------------mm-mm--B----B---------------------------------------------------------------m-#----m--------------m#####m--#
------------------------------------------------------------------------------m---m------------mO-B-m--BB------------mm----------------------------------------------------m-#-----m------------m#######mm-
---------------------------------------------------------------------------mmm-----m----------mm-----m---B----------mm-m---------------------------------------------------m-#------m----------m##########m
---------------------------------------------BBBBBBBB#--------------------mmBB------m---------mB------m---B--------mm---m-----------------------------------------B--------m-#-------m--------m############
-----------------------------------mmm--------------------------mm-------mm----------mmmmmmmmm---------m-----------m---------------------------------------------mmm-------m-#--------m------m#############
-----------------------------------m#-m----mm------------------m#-m------m----------K#############------m--mm----mm------m--------------mm-----------------------mB-m-----mY-#---------m----m##############
--mmmmmmmmmmmmmmmmmmmmmmmmmmmmmmmmm-#--mmmmm?mmmmmmmmmmmmmmmmmmm#--mmmmmm--------------------------------mmmmmmmm##-------mmmmmmmmmmmmmmh-mmmmmmmmmmmmmmmmmmmmmmm----mmmmmmy-#----------mmmm###############
#############################################################################-----------------------------#---#-#-#------Y-#-###############################################--##---------#-################
