----------------------------------------------------------------------------------------------------pP-------------------------------###-----##------------------------------------------------------------
----------------------------------------------------------------------------------------------------##------------------------------------#######----------------------------------------------------------
-------------------------------------------------------------------------------------------------------------------------------mm--------------------------------------------------------------------------
------------------------------------------------------------------------------------------------------------------------------m--m-------------------------------------------------------------------------
-----------------------------------------------------------------------------------------------------------------------------mm---m------------------------------------------------------------------------
-----------------------------------------------------------------------------B---------------V------------------------------m##----m------------------------#----------------------------------------------
------------------------------------------------------------------------------B--------------[]----------------------------m###-----m----------------------------------------------------------------------
-------------------------m-----------------------------------------------------B-------------pP------B--------------------m#####-----m-------------------------------------mm------------------------------
--------------------------mmmmmm-------------------------------------------mm----------mmm---pP--------------------------m#####-------m------------mm---------------------mm-mmm--------------mm-----------
--------------------mmmmmm#####-BBBBB-------------------------------------mm-m--------mm[]mm????M-mm--------mm----------m######--------m----------mm-mmm------------------m-----m------------mm-m----------
-------------------m###########-m----------------------------------------mm---m------mm-pP--m----mm-m------mm-m--------m########--------m------mmmm-----m--------------mmm-------m----------mm---mmm-------
------------------m############---BBBBBB---------------------------------m-----m-----m--pP---m---m---mmm---m---m------m########pP--------m----m#BM-------m-------------m[]--------m---------m--->---m---m-m
--mmmmmmmmmmmmmmmm#############--mmmmmmmmmmmmmmmmmmmmmmmmmmmmmmmmmmmmmmmm-------mmmmm---pP----mmm----[]-mmm-----mmmmmm#########[]---------mmmm##----------mmmmmmmmmmmmm-pP---------mmmmmmmmm----->---mmm-m#
#########################################################################--------#################---pP--##------###############-----------#-###----------K-#################-------##########--------##-##
