---------------------------------------------------------------------------------------------------------------------------------------------------##------------------------------------------------------
--------------------------------------------------------------------------------------------------------------------------------#############------##------------------------------------------------------
-----------------------------------------------##----------------------------------------------------------------------------------------------######------------------------------------------------------
----------------------------------------------------------------------------------------------------------------------------------------------------------------------m------------------------------------
-------------------------------------------------------------------------------------------------mmm----------------------------------------------------------------mm-m-----------------------------------
------------------------------------------------------------------V-----------------------------m##-m--------------------------------------------------------------m##--m----------------------------------
------------------------------------------------------------------[]---------------------------m###--m---------------------------mm-----------------------------mmm###---m---------------------------------
------------------------------------------------------------------pP--------------------------m####---m-------------------------mm-m-----------------------------C####----m--------------------------------
----------------------------mm-----------mmm----------------mmm---pP--------mm---------------m######---m---------mm--mm--------mm---m-----------mm--------------m#####-----m----------------------------mm-
---------------------------mm-mmm-------mm[]mm-------------mm[]mm???M??----mm-mmm-----------m######-----m-------mm-mm--m-------m-----m---------mm-mmm----------m######------m--------------------------mm-m
--------------------------mm-----m-----mm-pP--m------------m-pP--m--------mm-----m---------m#######------m-----mm-------m---mmm-------m-------mm-----m--------m#######V------m------------------------mm---
--------------------------m-------m----m--pP---m----m-----m--pP---m-------m-------mm--mm--m########-------mm-m-m---------mm-m[]--------m------m-------m------m########[]------m-----------------------m----
--mmmmmmmmmmmmmmmmmmmmmmmm---------mmmm---pP----mmmm-mmmmmk--pP----mmmmmmm--------#-mmk-mm##########------#-m-m------------m-pP---------mmmmmm---------mmmmmm#########pP-------mmmmmmmmmmmmmmmmmmmmmmm-----
############################################-----#-#--#####################-------#################################----########----------#-#-#------##--##############################################-----
