------------------------####################################################-------########################################################################################################################
-----------------------------------------------------------------------------mm----########################################################################################################################
----------------------------------------------------------------------------mm-mmm--#######################################################################################################################
----------------------------------------------------------------------------m-----m--######################################################################################################################
-------------------------------------mm------------------------------------m-------m-######################################################################################################################
-----------------------------------mm--m----------------------------------m?---------######################################################################################################################
----------------------------------m##B--m--------------------------------m?---------m-#####################################################################################################################
---------------------------------m###----m------------------------------m#----------#m-####################################################################################################################
-------------------mm----------mm####-----m----------------------------m##----------##m-###################################################################################################################
------------------mm-mmm------mh#####------m--------------------------m###----------###m-#####################################pP###########################################################################
-----------------mm-----m----m#######?------m---------------mmm------m####----------####m-########################################################################################-------------------------
-----------------m-------m--m########--------m-------------mm#-m----m#####----------#####m----------------------------------------------------------------------------------------mmmmmmmmmmmmmmmmmmmmmmmmm
--mmmmmmmmmmmmmmm---------mm#########---------mmmmmmmmmmmmm#-#--mmmm######----------######mmmmmmmmmmmmmmmmmmmmmmmmmmmmmmmmmmmmmmmmmmmmmmmmmmmmmmmmmmmmmmmmmmmmmmmmmmmmmmmmmmmmmmmm#########################
######################-----##########---------#-#-#-#-#-#-#--#---#-#######----------#######################################################################################################################
