---------------------------------------------------------------------------------------------------------pP------------------------------------------------------------------------------------------------
-----------------------------------------------------------------------------------------------------------------------------------------------------------------------------------------------------------
--------------------------------------------------------------------------------------------------###------------------------------------------------------------------------------------------------------
-----------------------------------------------------------------------------------------------------------------------------------------------------------------------------------------------------------
-----------------------------------------------------------------------------------------------------------------------------------------------------------------------------------------------------------
------------------------------------------------------------------------------------------------------------------------------------------------------K---BBBBBBBBBBBBM------------------------------------
-----------------------------------------------------------------------------------------------------------------------------------------------------------------------------------------------------------
--------------------------------------------------------------------------------------------------------------------------------------------------mm-------------------------------------------------------
-----------------------------------mmm-----------------------------------------------------mmm---------------------------------------------------mm-mmmmmmmmmmmmm------------------------------------------
----------------------------------mm[]m-B?------------------------------------------------mm[]mm-------mm---------------------------------------mm----[]??MBBBBB-m--O???-----------------------------------
---------------------------------mm-pP-m--???M???M??M????????M???M??????M----------------mm-pP--m-----mm-mmmm----------------------mmm----------m-----pP----------m-----????-------------------------------
---------------------------------m--pP--m------------------------------------------------m--pP---m----m---[]-m-------mm------------m#-m----mm-mm------pP-----------m---------------------------------------
--mmmmmmmmmmmmmmmmmmmmmmmmmmmmmmm---pP---mmmmmmmmmmmmmmmmmmmmmmmmmmmmmmmmmmmmmmmmmmmmmmmm---pP----mmmm----pP--mmmmmmmk-mmmmmmmmmmmm-#--mmmmk-mkk-k----pP------------mmmmmmmmmmmmmmmmmmmmmmmmmmmmmmmmmmmmmmm
##############################################################################################-----#-#----pP---############################################################################################
