-------------------#------------------------------------------------------------#----##################-#################################---------------------------------------pP-------------------------
------------------------------------------------------------------------------------------------------------------------------------------##------------------------------------##-------------------------
------------------------#----------------------------------------------------------------------------------------------------------------------------------------------------------------------------------
------------------------#----------------------------------------------------------------------mm-----------------------------------------------------------------##---------------------------------------
----------------------------------------------V--------------------------------m--------------mm-m------------------------------mm-------------------------------------------------------------------------
----------------------------------------------[]-----------------------------mm??--M---------mm#--m----------------------------mmgmmm----------------------------------------------------------------------
--------------------BB------------------------pP----------------------------m##-???-----------##---m----------------------------###--m---------------------------------------------------------------------
----------------------B------------------mmm--pP---------------------------m##?--------------m##----m--------------------------m###---m--------------------------------------------------------------------
------------------mM---BB---------------mm[]mm????M??????-----------------m###-?------------m###-----m------------------------m####?---m---------mm---------mm--------------------------mm---------mm------
------------------mmmm---BBB-----------mm-pP--m--------------------------m####-?M--??M-----m####------m----------------------m#####-----m-------mm-mmm-----mm-mmm-------------mm-------mm-mmm-----mm-mmm---
----------------mm-B#-m-----B----------m--pP-----mm---------------mm----m#####--M-?--?----m#####V------m--------------------m######------m-----mm-----m---mm-----m----mm-----mm-mm----mm-----m---mm-----m--
----------------m#-----m---Bmmmmmmmmmmm---pP---mmk-mmmmmmmmmmmmmmmh-mmmm######---?-------m######[]------m-----m----m----m--m#######-------m----m-------m--m-------m--mm-mmm--m----mm--m-------m--m-------m-
--mmmmmmmmmmmmmm-#------mmmm####################################################-mmmmmmmm#######pP-------mmmmm-mmmm-mmmm-mm########--------mmmm---------mm---------mmm-----mm----[]-mm---------mm---------m
####################-----###----------------------------------------------------################[]-------#-#-#--#-#--#-#--#########---------#-#----------#----------#-------#----pP--#----------#----------
