-------------------------------------################################-----------#############################################################----#####---------#--------------------------------########---
-----------------------------------------------------------------------------------------------------------------------------------------------######################--------------------------------------
----------------------------------mm----------------------------------mm-----------------------------------------------------------------------------------------------------------------------------------
---------------------------------mm-m--------------------------------mmmm----------------------------------------------------------------------------------------------------------------------------------
-------------------------------mmm---m-------------------------------m---m---------------------------------------------------------------------------------------------------------------------------------
------------------------------m#?-----m--------------------------mmmm-----m---------------------------m----------------------------------------------------------------------------------------------------
-----------------------------m##-------m-------------------------mg##?-----m------------------------mm-m----------------------------------------------m-mm-------------------------------------------------
----------------------------m###--------m-----------------------mg###-------m----------------------m##--m--------------------------------------------mgm?-m------------------------------------------------
---------------------------m####---------m----------------------m####--------m--------------------m###---m-----------------------------------------mm##?-?-m---------------------------mmm-----------------
--------------------------m#####----------m--------------------m#####---------m------------------m####----m--------------------------?M?------------###-----m-------------------------mm[]mm-????----------
-------------------------m######-----------m------------------m######----------m----------------m#####-----m----------------------------B----------m###?-----m---------------mmm-----mm-pP--m---?M?----mm--
------------------------m#######------------m-------------m--m#######-----------m----m------m--m######------m----m------mm----m----m--------mmm---m####-?-----m----m---------mC-m----m--pP---m--------mm#m-
--mmmmmmmmmmmmmmmmmmmmmm########-------------mmmmmmmmmmmmm-mm########------------mmmm-mmmmmm-mm#######-------mmmm-mmmmmm#-mmmm-mmmm-mmmmmmmm##-mmm#####--------mmmm-mmmmmmmmm-c--mmmm---pP----mmmmmmmm#-#-m
##################################---#-------#-#-#-#-#-#-#--#########-########----#-#--#-#-#--########--------#-#--#-#-#---#-#--#-#--##k-#-#-#--#######---------#-#--#-###########################-#-#--#--
