----------------------------------------------------------------------------------------------#pP----------------------------------------------------?-----------------------------??----------------------
-----------------------------------------------------------------------------------------------pP-m-------------------------------------------------mm-----------------------------m??---------------------
---------------------------------------------------------------------------------------------mm####m--------mmm---K---------------mmm---------------m-m----------------mmmm-------mY--?--------------------
--------------------------------------------------------------------------------------------mm-----#mmm-m---mC-m----------------K-mC-m---K---------mC--m---------------m[]-m------my-----------------------
--------------------------------------------------------------------------------------------m--mm---##-m-mmm-c--mmmmmmmmmmmmmmmmmm-c--mmmmmmmmmmmmmmC---mmmmmmmmmmmmmmm-pP--mmmmmm-#-----------------------
---------------------------------BBBBBB----------------------------------------------------m---------##################################################################-pP#############mmmm----------------
-----------------------------mm------------------------------------------------------------m-------------------------------------------------------------------------------------------#>>-m---mm----------
----------------------------mm-mm---------------------------------------------------------mm------------------------------------------------------------------------------------------------mmmh-mmmmmmmmmm
---------------------------mm----mm-------------------------------------------------------m?-----------------------------------------------------------------------------------------------################
---------------------------m-----C-m----------mm-----------------------------------------m-----------------------------------------------------------------------------------------------------------------
-------------------------mm------pP-m--------m--m----------------------------K---mm-----mC------##---------------------------------------------------------------------------------------------------------
-------------------------mC------c --m--mm---m---m-----------------mm-----------mC-m----mc------pP------------------------------------------------------------------------------------M--------------------
--mmmmmmmmmmmmmmmmmmmmmmm-c------pP---mmh-mmmm----mmmmmmmmmmmmmmmmmh-mmmmmmmmmmmmc--mmmmmc------pP#----------------------------------------------------------------------------------m---------------------
###############################################################################################-pP----------------------------------------------------------------------------------##---------------------
