----------------------------------------------------------------------------------------------------------------------------#######--##pP--------------------------######------------#--?---------?---#####
-----------------------------------------------------------------------m----#---------------------------------------------------------##---------------------------------------------##--?-------m---######
----------------------------------------------------------------------m-m----######----------------------------------------------------##--------------------------------------------pP--------###---######
--------------------------------------------------------------------mm?--m-----------------------------------------------------------------------------------------------------------pP--------###---######
-------------------------------------------------------------------mm#----m----------------------------------------------------------------------------------------------------------pP#------####---######
------------------------------------------BBBBBBBBBBB*B-----------m###-----m---------------------------------------------------------m----m------------------------------------------##-#####-####---######
-----------------------------------------------------------------m####------m----------#####----------------------------------------mmmmmm-m-------------------------------------------------#####---######
----------------------------------------------------------------m#######-----m------------------------------------------------------m-#k#?--m--------------------------------------mm--------###-#---######
---------------------------------------mmm---------------------m######---------------mm------------mm----##----------mm---------------###----m---------------mm-------------------mm-m------m-#---###--###-
--------------------------------------mm[]-B?BBBBBBBBBB-------m#######--#-----m-----mm-m----------mm-mmm--#---------mm-mmm--------mm--###-----m-----mm------mm-mmm----------------m--------mmm--------m-#-m
-------------------------------------mm-pPm------------------m########---------m----m---m---mm---mm-----m----------mm-----m------m##--###------m---mm-m----mm-----m------------mmm----m---mm--------mm---m#
-------------------------------------m--pP-m-------mm-------m#########[]--------m--m-----m--m-m--m-------m----mm-m-m-------m----m###--###-------m--m---m---m-------m----mm-----m[]-----m--m---mm----m#-mm##
--mmmmmmmmmmmmmmmmmmmmmmmmmmmmmmmmmmm---pP--mmmmmmmh-mmmmmmm##########[]---------mmO------mm---mm---------mmmm#-m-m---------mmmm####--###--------mm-----mmm---------mmmm#-mmmmm-c-------mm---------m---k###
#######################################################################-----------#--------#----#----------#-#########-------#-#####--###---------#------##----------#-#---#######-------#---------#---####
