-------------------------------------------------------------------------------########-------------------------------------------############################---------------------------------------------
-------------------------------------------------------------------------------########--------------------------------------------------------------------------------------------------------------------
-------------------------------------------------------------------------------##########----------------------------#-------------------------------------------------------------------------------------
-----------------------------------------------------------------------------------------------------------------------------------------------------------------------------------------------------------
------------------------------------B--------------------------BB------------------------------------------------------------------------------------------------------------------------------------------
-----------------------------------BBBB----------------------?B---------------------------------------------------------------------------------------------------------------------------------------BBBB-
------------------------------------m--B------------------------------------------------m-----------------------------------------------------------------------------------------------------------------B
-----------------------------------mmmB-B--------------------------------mm------------m-m----------------------------------------------------------------------mm-----------------------------------------
----------------------------------mm-#m--BBBBBBB?#-----------mmBBB#-----mm-mmm--------m#--m-------------------mm-----------mm----------------------------------mm-m-------mm------------------------mmm----
----------------------------------m?--#m--------------------m#-m-------mm-----m------m##---m-----------------mm-mmm-------mm-mmm---------------------------mm--m---m-----mm-mmm--------------------mmB-mmm-
------------------mmm----mm------m?----#m-------------------m#--m------m-------m----m###----m---mm----mm----mm-----m-----mm-----m--------------------------m-mm-----m---mm-----m-------mm---------mm------m
------------------mC-m--mC-m-----m------#mmmmmmmmmmmmmmmmmmmm#---mmmmmm---------m--m####-----m--m-m--mm-m---m-------m----m-------m----m----m--------------m--[]------m--m-------m------m-m--------m--------
--mmmmmmmmmmmmmmmm-c--mmmc--mmmmmm-------##################################------mm#####------mm---mmm---mmm---------mmmm---------mmmm-mmmm-mmmmmmmmmmmmmm#--pP-------mm---------mmmmmm---mmmmmmmm---------
###################################-----------------------------------------------######-------##---#-----##----------#-#----------#-#--#-#--#-#-#-#-#-#-#---pP--------#----------################---------
