---------------------------------###########################---------------------------------------------------#############################################################################---------------
--------------------------------------------------------------------------------------------------------------------------------------------------------------------------------------------#--------------
-----------------------------------------------------------------------------------------------------------------------------------------------------------------------------------------------------------
-----------------------------------------------------------------------------------------------------------------------------------------------------------------------------------------------------------
-------------------------------------------------------------------------------------------------------------------------m---------------------------------------------------------------------------------
---------------------------------------------------mmm-----------------------------------------------------------------mm-m--------------------------------------------------------------------------------
-----------------------------mm-------------------mmg-m--------------------------------------------BBBB---------------m##--m-------------------------------------------------------------------------------
----------------------------mm-mm-----------------mg#--m-----------------------------------------------B------------mm###---m------------------------------------------------------------------mm----------
---------------------------mm----mm---------------m##---m------------------------------------------mm---B------------####----m----------------------------------------------------------------mm-m---------
---------------------------m-----C-m-------------m###----mmm----??--------------------------------mm-m-----mm-------m####-----m----------------------------------------------mmmmmmmmmmmmmmmmmm---m--------
-------------------------mm------C--mm----------m####----MM-m------------------------------------mm---m---mm-m-----m#####------m--------------------------------------------m#################-----m------m
-------------------------mC------c--C-m--------m#####V-------m-----------------------------------m-----m--m---m---m######-------m-------------------------m--------m--mmm--m################-#------m-----m
--mmmmmmmmmmmmmmmmmmmmmmm-c------c--c--mmmmmmmm######[]-------mmmmmmmmmmmmmmmmmmmmmmmmmmmmmmmmmmm-------mm-----mmm#######--------mmmmmmmmmmmmmmmmmmmmmmmmm-mmmmmmmm-mm##-mm#################---------mmmmm-
##################################--c---#-#-#-#######pP--------##################################--------#------#########--------#-#-#-#-#-#-#-#-#-#-#-#-#--#-#-#-#--#-#--##################----------####-
