-----------------#---B----------------------------------------------#--###################################--------------------------------------#-------------------------------------------#########-#####
------------------#---#--------------------------------------------------------------------------------------------------------------------------------------------------------------------------------####
-------------------#---#-----------------------------------------------------------------------------------------------------------------------------------------------------------------------------mm----
--------------------#-----#-------------------------##-----------------------------------------------------------------------------------------------------------------------------------mm---------mm-m---
---------------------#-----#------------------------------------------------------m----------------------------#------------------------------------------------------------------------mm-m--------m------
--------------------------------------------------------------------------------mm-m----------------------------------------------------------V-V--------------------------------------mm---m------m----mmm
-------------------------------------------------------------------------------m##--m---------------------------------------------------------[][]----------------------------------m-mm-----mmm--mB-------
---------------mmmmB----------------------------------------------------------m###---m-----------------------mm-------------------------------pPpP---------------------------------m--m----------m#--------
--------------mg#BBmB--------------------------------------------------------m####----m---------------------mm-m-------------------------mmm--pPpP---------------------------------mgm----------m##--------
--------------m##+---B-----------mm-----------mmm------------mm--------------m####-----m-------------------mm---mm----------------------mm[]mm??????M?M????M???M???M??M?M?M--------m##----------###--------
--------------m##---m-Bmmmm-----mm-m---------mmm-mmm--------mm-m---mmm------m#####------m------------------m------m--------------------mm-pP--mm-?--------------------------------m###---------####--------
-------------m###--B---BBB-m----m---m--------m-Y----m--mm---m---m--mY-m----m######-------m-----m----m----mm--------m--K----------------m--pP----m--mmmm----mm--------mm----mm----m####---------####-------#
--mmmmmmmmmmm####---Bmm-----mmmm-----mmmmmmmm--y-----mmm-mmm-----mm-y--mmmm#######--------mmmmm-mmmm-mmmm##---------mmmmmmmmmmmmmmmmmmm---pP----kmmt-k-mmmmk-mmmmmmmmk-mmmmk-mmmm#####--------#####------##
##################---B#-----M?-#------##########------#---##------###---#-########--------#-#-#--#-#--#-#-#----------##############################################################################---#-###
