-------------------------------------------------#------------------[]-------------------------------------------------------------------------------------------------------------------------------------
--------------------------------------------------#----######-------pP-------------------------------------------------------------#-----------------------------------------------------------------------
---------------------------------------------------#----------------pP-------------------------------------------------------------------------------------------------------------------------------------
------------------------------------------------m-------------------pP-------------------------------------------------------------------------------mm----------------------------------------------------
-----------------------------------------------mm-------------------pP-------------------------------------------------------------------------m-mm-mm-m---------------------------------------------------
-----------------------------------------------mg-------------------pP------------------------------------------------------------------------m-mm-mm---m--------------------------------------------------
-----------------------------------------------mg-m-----------------pP-------------------------------------------mm---------------------------mg#-??-----m-------------------------------------------------
----------------------------------------------m##?----#-------------#####----------------------------------------m-m---------mm---------------m##?--------m------------------------------------------------
---------------------------------------------m###+-m-----------mm---------------------------mm-------------mm---m---m------mmm-mmm-----------m###?---------m-----------------------------------------------
------------------mmmmmmmmmmmmmmmmmmmmmmmmmmm####---m---------mm-mmm---------------B-------mm-mmm---------mm-mmm>----m--mm-mm-----mm--------m####-----------m-----------------mm-----mm-----mm------mm---mm
-----------------m###############################----m-------mm-----m----mm----mm---------mm-----m-------mm----?------m-m-m-------?-m------m#####------------m---------------mm-m---mm-m---mm-m----mm-m--m-
----------------m################################-----m------m-----------m-m---m-m--m-----m-------m------m-------------m--#----------m----m######-------------mm-m-----------m---m--m---m--m---mm--m---mm--
--mmmmmmmmmmmmmm#################################------mmmmmm--------mmmm---mmm---mm-mmmmm---------mmmmmm--------------#####----------mmmm#######-------------#-m-mmmmmmmmmmm-----mm-----mm------mm---->>--
##################################################------#-#-#--------V#-#----##----#--########------#########--------------------------######################################------#------#-------#--------
