----------------------------#-----#------------------------------------------------------------------------------------------------------------------------------------------######------------------------
-----------------------------##########---------##---------------------------------------------------------------------------------------------------------------------------------------------------------
-----------------------------------------------------------------------------------------------------------------------------------------------------------------------------------------------------------
--------------------------mm-------------------------------------------------------------------------------------------------------------------------------------------------------------------------------
-------------------------mm-m------------------------------------------------------------------------------------------------------------------------------------------------------------------------------
-------------------------mg?-----------------------------------------------------------------------mm------------------------------------------------------------------------------------------------------
------------------------m##--m--------------------------------------------------------------------mm-mmm---------------------------------------------------------------------------------------------------
-----------------------m###-----------------------------------------------------------------------m-----m--------------------------------------------------------------------------------------------------
----------------------m####---m-----------mm---------------mm-------------------mm-------------mmm-------m-------mm-------------------------------mm------------------------------------mm-----------------
---------------------m#####----m---------mm-mmm-----------mm-mmm-----mm--------mm-mmm---------m???--------m-----mm-mmm-----mm-----mm------mm-----mm-mmm-----mm-----mm------mm-----------m-m---------------m
--------------------m######-----m-------mm-----m---------mm-----m---mm-m------mm-----m--------m------------m---mm-----m---mm-m---mm-m----mm-m---mm-----m---mm-m---mm-m----mm-m--------mm---m-------------mm
-------------------m#######------m----M-m-----K-m----mm--m-------m--m---m-----m-------m-------m-------------m--m-------m--m---m--m---m---m---m--m-------m--m---m--m---m---m---m----mm-m>----m------------m-
--mmmmmmmmmmmmmmmmm########-------mmmmmm---------mmmmk-mm--K------mm-----mmmmm---------mmmmmmm---------------mm---------mm-----mm-----mmm-----mm---------mm-----mm-----mmm-----mmmm#-m-------mmmmmmmmmmmm--
#############################------#-#-#----------#-########------>>------#######-------#########------------>>----------#------#----->>>----->>----------#------#------##------#-#--#--------#############
