-----------------------------------------------------------------------------------------------------#############--#-#--------------------?------------------------------------------->##-----------------
-------------------------------------##########---------------------------------------------------------------------###########-----------------------------------------------------------##---------------
-----------------------------------------------------------##------------------------#---------------------------------------------------------------------------------------------------------------------
-----------------------------------------------------------------------------------------------------------m----------------------------Y------------------------------------------------------------------
--------------------------------------------------------------------------------------------------------mmm-m--------------------#######y------------------------------------------------------------------
-------------------------------------------------------------------------------------------------------mg##--m--------------------------#------------------------------------------------------------------
----------------------------------M-----------------------------------------------------------------mmm####---m--------------------------#-----------------------------------------------------------------
----------------------------------------------------------------------------------------------------m######----m-----------------------mm-#----------------------------------------------------------------
----------------------------------------------------------------------------------------------------m######-----m---------------------mm---##--------------------------------------------------------------
----------------------------------mm-------------mm-------mm-------mm-----mm-----mm----------------m#######?-----m---------------mm---m--m-------mm----------mm-----------mm-------mm-----------mm-------mm
------------------------mmm------m#-m-----------mm-m-----mm-m-----mm-m---mm-m---mm-m--------------m########-------m-------------mm-mmm----m-----mm-m---mm---mm-m----mm---mm-m-----mm-m---------mm-m-----mm-
------------------------mC-m-----m#--m----------m---mmm--m---mm---m---m--m---m--m---m----m-------m#########--------m----m------mm----M-------m--m---m--m-m--m---mm--m-m--m---m----m---m--------m---m----m--
--mmmmmmmmmmmmmmmmmmmmmm-c--mmmmmmC---mmmmmmmmmm-------mm----B-mmm-----mm-----mm-----mmmm-mmmmmmm##########---------mmmm-mmmmmmm-----------mm-mm-----mm---mm------mm---mm-----mmmm-----m----mmm-----mmmm---
###################################----##-#-#-##--------#-------##------#------#------#-#--################----------#-#--#-#-#-------------#--#------#----#-------#----#------#-#------#--##-#------#-#---
