----------------------------------------------------------------------------------------k------#######--------#------------------------------------#####-------#####-------------------------------------##
---------------------------------------------------------------------########################################-#####------------------------------###########--#####V---------------------------------------
------------------------------------------------------------------------------------------------------------------------------------------------------------#######[]--------------------------------------
------------------------------------------------------------------------------------------------------------------------------------------------------------mm##-##pP--------------------------------------
-----------------------------------------------------------------------------------------------------------------------------------------------------------mmmm---###--------------------------------------
-------------------------------------------------------------------B-----------------------------------m--------------------------------------------------mm----------#------------------------------------
----------------------------------------------------MB-----------------------------------------------mm-m--------------------------------mm--------------mm----mm------####--------------------------------
----------------------------------------------------------------------------------------------------m##--m------------------------------m#-m-------------m-------m---m-------------------------------------
-----------------------------Km---------------------------------mmmm-------------------------------m###---m-----------mm---------------m##B?mm----------m-----------m#mm----------------------mm-----------
----------------K------------mmmm-------------------mm---------mm[]-m-----------------------------m####----m---------mm-mmm-----------m###--B-m--------m#---------mm#-#----------mm----------mm-mmm--------
---------mmm------Kmm-------mm-C-m------mm---------m#-m-------mm-pP--m---------------------------m#####-----m-------mm-----m---------m####-----m------m##---------###---m--mm---mm-m--------mm-----m--mm---
---------mC-m-----mC-m-------C-c--m----mC-m--------m#--m------m--pP---m-------------------------m######------m------m-------m-------m#####------m----m###--------####------m-m--m---m-------m-------m-m-m--
--mmmmmmm-c--mmmmmmC--mmmmmmmc-c---mmmmmc--mmmmmmmmm#---mmmmmm---pP----mmmmmmmmmmmmmmmmmmmmmmmmm#######-------mmmmmm---------mmmmmmm######-------mmmm####-------######---mm---mm-----mmmmmmm---------m---mm
###################################################################----##-#-#-#-#-#-#-#-##-#-#-########--------#-#-#----------#################---#######-------#####-----#----#------#-#######------>>---#
