------------------------##################-----------------?--####################---------------######--------------------------------------------##----------------------------#-------------------------
------------------------------------------#----------------V---------------------------------------------------------------------------------------------------------------------#-------------------------
-------------------------------------------#########-------[]-----------------------mm---------------------------------------------------------------------------------------------------------------------
-----------------------------------------------------------pP----------------------mm-mmm------------------------------------------------------------------------------------------------------------------
-----------------------------------------mm----------------pP----------------------m-----mm----------------------------------------------------------------------------------------------------------------
----------------------------------------mm-mm--------------pP-------------------mmm------K-m---------------------------------------------------------------------------------------------------------------
----------------------V------------mmmmmm----m-------------pP------------------m??M---------m--------------------------------------------------------------------------------------------------------------
----------------------[]----------m#????------m------------pP----------------mm#-------------m-------------------mm------mm----------------------------------------------------------mm--------------------
------------------mmm-pP---------m##-----------m-----------pP-----------------##--------------m-------------mm---m-m----mm-mmm-------------------------------------------------------m-mmm-------------mm--
-----------------mm[]mB?Bk------m###------------m----------#-----------------m##---------------m-----------mm-mmm---m--mm-----m---------------mm---??-mm---------------------mm-----m---K-m-----------mm-mm
----------------mm-pP-m-M???---m####-------------m----mm--------------------m###----------------m---------mm----B----m-m-------m-------------mm-m----mm-m-------------------mm-m---mm--->--m---------mm----
----------------m--pP--m------m#####--------------m--mm-mmm--m-------m--m--m####-----------------m----mm--m-----------m---------m------------m---m---m---mm-----------------m---m--m?-------mm--mm---m-----
--mmmmmmmmmmmmmm---pP---mmmmmm######---------------mmm-----mm-mmmmmmm-mm-mm#####------------------mmmm#-mm-----------######------mmmmmmmmmmmm-----mmm------mmmmmmmmmmmmmmmmm-----mm---------B-mmk-mmm------
##########################-#-#######----------------#-------#-#-#-#-#--#--######-------------------#-#---##-------------------------#########------##-----K-################------#------------######------
