-----------------------------------------------------------------------------------------------------------?##-------------V---------------------pP-?#############################################---------
-----------------------------------------------------------------------------------------------------------###-------------[]--------------------------------------------------------------------#---------
---------------------------------------------------------------------------------------------------------#####-------------pP------------------------------------------------------------------------------
----------------------------------------------------------------------------------------------------------############-----pP------------------------------------------------------------------------------
----------------------------------------------------B----------------------------------------------------------------------pP--------------------------------------------m---------------------------------
----------------------------------------------------mm---------------------------------------------------------------------pP----------------------------------------mmmm-m--------------------------------
----------------------------------------------------m-m---------------------------------M----------------------------------pP----#-----------------------------------m###--m-------------------------------
---------------------------------------------------m---m-------------------------------------------------------------------######-----------------------------------mg###---m------------------------------
---------------------mm---------------------------mm----m----------------------------------------------m------------------------------------------------------------m####----m-----------------------------
------#-------------mm-m--------------------------mB-----m------------------------------mm---------mmmmmm-------------------------mm----------mm-------------------m#####-----m----------------------------
-------------------mm---m-----------------------mm--------m----mmm------------mmm------m#-m-------mmm[]--m----mm--------mm------mmm-m--------mm-m-----------------m######------m-----------------mm--------
-------------------m-----m----------------------mC---------m---mC-m----------mmC-m-----m##-m------m--pP---m--m#-m------mm-mm----m#---m----m--m---m-------m----m--m#######-------m---m------m----mm-mmm-----
--mmmmmmmmmmmmmmmmm-------mmmmmmmmmmmmmmmmmmmmmm-c----------mmm-c--mmmmmmmmmmm-c--mmmmmm#---mmmmmm---pP----mm##--mmmmmmm----mmmm------mmmm-mm-----mmmmmmm-mmmm-mm#######---------mmm-mmmmmm-mmmm#-----mmmmm
####################################################-----##############################################-----###--BBBB-#------#-#-------#-#--#-----[]-##-#--#-#--#########--------#-#--#-#-#--#-#--#----####
