------------------------------------?#--------------#---y-?---pP--------------#-------##################################--------------####-----------------#################################---------------
-----------------------------------------------------####-----pP-------------------------------------------------------#-------------#####-----------------------------------------------------------------
--------------------------------------------------------#-----########---------------------------------------------------######------#####--------------------------------------------------------------##-
-----------------------------------#----------------------------------#------#------------------------------------------------------####pP-----------------------------------------------------------------
-----------------------------------------------------------------------####---#--------------------------------------------------###############-----------------------------------------------------------
----------------------------------------BBBMM---------------------------------------------------------------------------------------------------------------------------------------mmmm-------------------
-------------------------------------BBB------------mm---------------------------------------------m-------------------------------------------------------------------------------m###-m------------------
--------------------------------------B------------mm-m-----------mm------------------------------m-mmm------------------BB-------------------------------------------------------m####--m-----------------
----------------------------mm---------------------m---m---------mm-mmm---------------------------mg---m-----------------mm----------------m-------------------------------------m#####---m-------mm-------
---------------------------mm-mmm---Bk--BBBBBB---mm-----m----mm-mm-----m------BBBB-mm-------------mc#---m--------------mmm-m-----mm------mm-m-----mm----------------------------m######----m-----mm-mmm----
--------------------------mm-----m---BBB--------m[]---------mm-mm-------m---------mm-mmm---------m###----m-------------m#---m---mm-m----mg#--m---mm-mmm------------------------m#######-----m---mm-----m---
--------------------------m-------m-------------mpP------m--m------------m--m-----m-----m----m--m####-----m----m-----mm-#?---m--m---mm--m##---m--m-----m-------m----m------m--m########------m--m-----K-m--
--mmmmmmmmmmmmmmmmmmmmmmmm---------mmmmmmmmmmmmmmpP------Cmm---[]---------mm-mmmmm-------mmmm-mm#####------mmmm-mmmmm##-#-----mm------mm###----mm-------mmmmmmm-mmmm-mmmmmm-mm#########-------mm---------mm
##############################------##-############------Y-#---pP----------#--#C-#--------#-#--######-------#-#---#-#-#-#------#-------####-----#--------##-#-#--#-#--#-#-#--##########--------#----------#
