-----------------------------------------------------------------------------------------------------------------------------------------##-#-?#----------######-#-----------------------------------------
----------------------------------------------------------------------------------------------------------------------------------------------#------------------#####-------------------------------------
-----------------------------------------------------------------------------------------------------------------------------------------------------------------------------------------------------------
-----------------------------------------------------------------------------------------------------------------------------------------------------------------------------------------------------------
--------------------------------------------------------------------------------------------------------------------------------------------------------------------------------------------------------mm-
-------------------------------------------------------------------------------------------------------------------------------------------------------------------------------------------------------mm-m
-----------------------------------------------------------------------------------------------------------------------------------------------------------BBBB----------------------------------mm----m---
------------------------------------------------------------------------------------------------------------------------------------------------------------------------------------------------mm-mmmm----
----------------M---------------------------------------------------mm---------------------mm-------------------------------------------------------mmmmmmmm---------------------------mm------mm----##----
---------------------mm----------------------------mm--------------mm-mmm------------------m?m----------?------------------------------------------m######O---------------mm----------mm-mmm---m-----------
---------------mmm--mC----------K-----K-Kmm-------m?-m------------mm--[]-m---????????----mm---m----------------------------------mmm----BB--------m#######--mBB----------mm-m----#---mm-----mmm------------
---------------m#-m-mK-m----------------mC-m------m---m-----------m---pP--m--------------m#-------------mm----------------------m[]-m----BB-m----m########-----mmm-------m---m-------m------#######--------
--mmmmmmmmmmmmm-B--mm---mmmmmmmmmmmmmmmmmc--mmmmmmm----mmmmmmmmmmm----pP---mmmmmmmmmmmmmm-#----mmmmmmmmmh-mmmmmmmmmmmmmmmmmmmmmmmpP--mmmmmmmmmmmm#########---mm##-mmmmmmm-----mmmmmmm----------------------
############################################################################################################################################-#-############---###--#-##-#-----B-#-#######------------------
