--------------------------------------------------k#######--------------------------------pP------------#----------------------------------------------------------------------------------------------B---
----------------------------------------------#############----#-------------------------->###########--#-------------------------------------------------------------------------------------------mm-----
----------------------------------------------------------------#---------------------------------------#-------------------------------------------------------------------------------------------mgmm---
-----------------------------------------------------------------#######--------------------------------#-------------------------------------------------------------------------------------------m#B-m--
-------------------------------------------------------------mmm------------------------------------------------------------------------------------------------------------------------mm---------m##---m-
------------------------------------------------------------mmm-m----------------------------------------------------------------------------------------------------------------------mm-mmm-----m###----m
-----------------------------------------------------------mB----m--------------------------------------------------------------BBBBBB-------------------mmm--------------------------mm-----m---m####---B-
----------------------------------------------------------m?------m-----------------------------------------------m---------mmmm------------------------mm#-m-------------------------m-----K-mmm#####----B
--------------mmm------------------------mmm-------------m#--------m---------------------mm---------------------mm-m----mm--m[]-m-----------------------m-#--m--MM-----K-------------m--------#########----
-------------mm[]mm-???-----------------mm[]mm----------m##---------m-----mm------------mm-mm-----------m-------m#--mmmmk-mm-pP--mmmmmmmmmmmmmmmmmmmmmmm--#---mmmmmmmmmmmmmmmmmmmmmmm#---------------------
------------mm-pP--m-?-??????????????--mm-pP--m--------m###B---------m---mm-m----------mm----m---------mmmm---mm---###################################################################---------------------
------------m--pP---m------------------m--pP---m------m####-----------m--m---m----m----m------m--------m-k-m--m#-------------------------------------------------------------------------------------------
--mmmmmmmmmm---pP----mmmmmmmmmmmmmmmmmm---pP----mmmmmm#####------------mm--K--mmmm-mmmm--------mmmmmmmm--#--mm---------------------------------------------------------------------------------------------
############################################-----#-########-------------#------#-#-######--[]---#-#-#-#--#---#---------------------------------------------------------------------------------------------
