--------------------------------------------------------------[]-----------------------------------------##############---------------------------------------#----##------------------------------------##
--------------------------------------------------------------pP-------------------------------------------------------------------------------------------mm--#########-----------------------------------
--------------------------------------------------------------##------------------------------------------------------------------------------------------mm-----------------------------------------------
------------------------------------------------#----------------------------------------------------------------------m----------------------------------m--m---------------------------------------------
------------------------------------------------pP-------------------------------------------------------------------mm-m-----------------------------?B-m----m--------------------------------------------
--------------------------------------BBB----#--pP-------------------------------------MM---------------------------mg#--m---------------------------BB--m------------------------#------------------------
--------------------M------------------B------#-pP------------------------------------------------------------------m##---m-----------------------------m?-----m-------------------------------------------
--------------------K-----------m-------B------#pP-----------------------------------------------------------------m###----m-------------------------mmm?-----##m----------------------------------------mm
-------------------m-------------mmmmmmmmB------#-#------------------mm------------------------mmm----------------m####-----m-----------------------mm??------pP-m-mm-----------mm----------------------mm-
-------------------mmm----------m######?-m-m----------mm------------mm-mmm--------------------mm[]m-????---------m#####------m---------------------mm?--------pP--mm------mm---mm-m---------------------m--
-----------------mm-#-m--------m######----mmm--------mm-m---mm-----mm-----m---mm-------------mm-pP-m---????-----m######-------m--------------------m----------pP--M--mmmmmmmm--m---m-----------------mmm---
-----------------m#-#--m--mm--m#######----B--m--mmm--m---m--m-m----m-------m--m-m------------m--pP--m----------m#######--------mm-m----------------m----------pP----#--?MB---mm-----m----------------m[]---
--mmmmmmmmmmmmmmm-#-#---mmk-mm########--------mmm#-mm-----mm---mmmm---------mm---mmmmmmmmmmmm---pP---mmmmmmmmmm########--------#-m-mmmmmmmmmmmmmmmm--------->#[]----##--------B------mmmmmmmmmmmmmmmm-pP---
#######################################--------###--#------#---V#-#----------##############################-#-#########-##############################--------#-----##---------------###################---
