--------------------------------------------------------------------------------------------------------------#####---------?------##-------#--------------------------------------------------------------
------------------------------------------------------------------------------------------------------------###########-----------###----------------------------------------------------------------------
----------------------------------------------------------------------------------------------------------------------m##----?----###--------------------------------------------###-----------------------
-----------------------------------------------------------------------------------------------------------------------m-#--------###-------------------------------------------------#--------------------
--------------------------------------------------------h--h----------------------------------------------------------mmm-#------####--------------------------------------------------######--------------
------------------------------------------------BBBBBBBBBBBBBBBBBBBBBB-----------------------------------------------m-----#----#####----------------------------------------------------------------------
---------------------------------------------------------------------------------------------------------------------m---m--#############------------------------------------------------------------------
------------------------------------------------m-----------------------------------------------------------------m-mB----------mm-------------------------------------------------------------------------
-----------------------------------------------mmmmmmmmmmmmmmmmmmm-----------------------------------mm----------m-mB-----m----mm-----------#-----------------------------mm-----------mm------------------
-----------------------------------------------m?MBBB?????????BBB-m--O---------------------mm-------mm-mmm-------mg#-----------m--mm-------#---mm--------mm-----mm-------mm-mmm-------mm-m-----mm----------
--------------------------mmmm----------------mm-------------------m-----K--K-----mm------mmmmm----mm-----m------m##-------m--m-------m-------mm-mmm----mm-m---mm-m-----mm-----m-----mm---m---mm-mmm----mm-
--------------------------m[]-m---------------m---------------------m--K---------mC-m-----m--C-m---m-------m----m###----------m-----mm-m--m--mm-----m---m---m--m---mmm--m-------m----m-----m--m-----m---m-m
--mmmmmmmmmmmmmmmmmmmmmmmm-pP--mmmmmmmmmmmmmmm------h----------------mmmmmmmmmmmmmc--mmmmmm--c--mmm---------mmmm####--------mm?-----##--mm-mmm-------mmm-----mm-------mm---------mmmm-------mm-------mmm---
###################################################################################################----------#######---------#------##---#--#---------##------#--------#----------#-#--------#--------##---
