-----------------------------------------------------------------------------------------------------------------------------########################################---------------------####-------------
---------------------------------------------------------------------------------------------------------------------------------------------------------------------------------------------###-----------
------------------------------------------------------------------------------------------------------------------------------------------------------------------------------------------------#----------
-----------------------------------------------------------------------------------------------------------------------------------------------------------------------------------------------------------
----------------------------------------------------------------------mm-----------------------------------------------------------------------------------------------------------------------------------
---------------------------------------------------------------------mm-mmm------------------------------------------------------------mmmmmm--------------------------------------------------------------
---------------------m------------------------------------------mm---m-----m----------------------------------------------------------m###??-m-------------------------------------------------------------
--------------------m#m----------------------------------------mm-mmm-------m-----------------------------------------------------mmmm####----m------------------------------------------------------------
-------------------m##?m-----------mm----------------------mm--m---->--------m------------------------mm---------------mm----------mg#####?----m---------------------mm-------------mm-----------------#---
------------------m###-?m---------mm-mmm------------------mm-mm---------------m----------mm-----mm----m-m-----mm------mm-mmm------mg######------m-------------------mm-mmm---------mm-mmm------------------
-----------------m####--Mm-------mm-----m---mm-----------mm---B----------------m---mm---mm-m---mm-mmmm---m---mm-m----mm-----m----m########-------m-----------------mm-----m-------mm-----m---------mmm-----
----------------m#####----m------m-------m--m-m----------m----------------------m-mm-m--m---m--m---->>>---m--m---m---m-------m--m#########--------m---m------------m-------m------m-------m-------m?--m--m-
--mmmmmmmmmmmmmm######-----mmmmmm---------mm---mmmmmmmmmm------------------------mm---mm-----mm------------mm-----mmm---------mm##########---------mmm-mmmmmmmmmmmm---------mmmmmm---------[]--mmmB-M--mm-m
#########################---########-------#################---------------------K-----#------#------------>>------#####-------###########---------#-#--#-#-#-#-#-#----------########------pPk##-#------#->
