----------------------------------------------------##############################################################-------------------------------------------------------------k--------------pP--------?--
--------------------------------------------------------------------------------------------------------------------------------------------####--------------------##################---------------------
-----------------------------------------------------------------------------------------------------------------------------------------------------------------------------------------------------------
---------------------------------------------------------------------------------------------------------------------------------------------------------------------------------------------#-------------
----------------------------------------------------mm---------------------mm--------------------------------------mmmm----------------------------------------------------------------------pP------------
------------------------------------------mm-------mm-m--------------------m-m------------------------------------m##?-m---------------------------------------------------------------------##------------
-----------------------------------------mm-mmm---mm---m-----------------mm---m----------------------------------m###---m--------------------------------------------------------------------pP------------
----------------------------------------mm-----m--m-----m-------------mmm##----m--------------------------------mg###----m-------------------------------------------------------------------pP------------
----------------------mm----------------m-------mm-------m-------------g###-----m-------------------------------m####-----m----------mm-------------------------mm---------------------------[]---mm-------
---------------------mm-mmmm----------mm--------[]--------m-----------m####------m-----------------------------m#####------m--------mm-mmm---------------------mmVmm-------------------mm----#---mm-m------
--------------------mm----C-m--------m[]--------pP---------m---------m#####-------m---------------------------m######-------m------mm-----m-------------------mm-[]-m-----------------mm-mmm-----m---mmm---
--------------------m-----c--m--mm---mpP--------pP----------m------mm######--------m-------------m------mmm--m#######--------m-----m-------m------m-----------m--pP--m-----------m----m-----m--mm----[]---m
--mmmmmmmmmmmmmmmmmm------C---mmh-mmmmpP--------##-----------mmmmmm########---------mmmmmmmmmmmmm-mmmmmm##-mm########---------mmmmm---------mmmmmm-mmmmmmmmmmm---pP---mmmmmmmmmmm-mmmm-------mm[]----pP-mmm
##############################################------#---------#-#-#-#######---------#-#-#-#-#-#-#--#-#-#-#--######-####-------#########------#-#-##################----##-#-#-#-#--#-#--------#pP--------#-
