----------------------------------########----------------------------------------h----------------------------?###########################################################################################
------------------------------------------------------------------------------BBBBBBBBB-----------------------m############################################################################################
-------------------------------------------------------------------------------------BBB---------------------m#############################################################################################
-----------------------------------------------------------mmm----------------------------------------------m##############################################################################################
----------------------------------------------------------mm[]m-????--------mm-----------------------------m###############################################################################################
-----------------------V--------?B-----------------------mm-pP-m---??------mm#m-BBBBBB#-------------------m################################################################################################
-----------------------[]--------------------------------m--pP--m----M??--mm-#-m------------mmm----------m#################################################################################################
-----------------------pP-----------------mmmmmmmmmmmmmmm---pP---mmm------m--#--m--------K---#-m--------m##################################################################################################
------------------mmmm-pP----------------m##########################mmmmmm---#---mmmmmmmmmmmm#--mmmmmmmm###################################################################################################
-----------------mm[]-m-??M??---mm------m##-------------------------############################################--#########################################################################################
----------------mm-pP--m-----?-mm-m----m###------------------------------------------------------------------------########################################################################################
----------------m--pP-----mm---m---m--m####----------------------------------------------------------------------------------------------------------------------------------------------------------------
--mmmmmmmmmmmmmm---pP---mmt-mmm-----mm#####---------------------------------------------------------------------mmmmmmmmmmmmmmmmmmmmmmmmmmmmmmmmmmmmmmmmmmmmmmmmmmmmmmmmmmmmmmmmmmmmmmmmmmmmmmmmmmmmmmmmmmm
################################-----######---------------------------------------------------------------------###########################################################################################
