-------------------------------#---?---?------------------------------------#####--------------------------------------##----------K--------------------------------------------------------###############
--------------------------------#-----------------------------######----#############----------h-----------------------##----------------------------------------------------------------------------------
---------------------------------#---------------------------------------------------#####################----########-##----------------------------------------------------------------------------------
----------------------------------#------------------------------------------------------------------------------------######------------------------------------------------------------------------------
-----------------------------------#-----------------------------------------------------------------------------------------------------------------------------------------------------------------------
------------------------------------#----------------------------------------------------------------------------------------------------------------------------------------------------------------------
--------------------------------?----#--------------------------------------------------------------------------------------------------------------------------------------------------------------------m
---------------------------------Bh---#---------------------------------------------*BBB-----------------------------------------------------------------------------------------------------------------m#
------------------------------mm--B----####------------mm-----------------------m-------BBBBBBBBBBBBBBBBB----mm-----------------------------------------mm-m--------------------------mmm-m-------------m##
-----------------------------m??m--B------------------mm-mmm-------------------m----------------------------mm-m-------mmm-----------------mm----------mm-m-m-----mm-----------------mm[]m-m-----------m###
----------------------mmm---mC???m--B--------mm------mm-----m------------------mgmmmmmmmm-------mm---------mm---m------m--m----mm---------mm-m--------mm--B--m---mm-m---------------mm-pP---m---------m####
----------------------mC-m--m?---?m--mm--m---m-m--m--m-------m---------m------m###??MBBB-mmmmmmm--mmmmmmm--m-----m----m--#-m--mm-mmm---m--m---m-------m-------m--m---mm--------mm---m--pP----m----m--m#####
--mmmmmmmmmmmmmmmmmmmm-c--mmm-----?mmmmmm-mmm---mm-mm---------mmmmmmmmm-mmmmmm####------BBBBBBBBBBB?BBBB-mm-------mmmmB-k#--mmm-----mmm-mm-----mmmmmmm---------mm------mmmmmmmmh-mmm---pP-----mmmm-mm######
################################---?#---#-#-#----#--#####------##-#-#-#--#-#######------------------------#--------#-#--##---#-------##--#------#-#######-------#-------#################----#-#-#--#######
