-----------------------------------------------------------------------------------------------------------------------------------------------------------------------------------------------------------
-----------------------------------------------------------------------------------------------------------------------------------------------------------------------------------------------------------
-----------------------------------------------------------------------------------------------------------------------------------------------------------------------------------------------------------
-----------------------------------------------------------------------------------------------------------------------------------------------------------------------------------------------------------
-----------------------------------------------------------------------------------------------------------------------------------------------------------------------------------------------------------
---------------------------------------------------B------------------------------------------------------------------------------------V----------------------------------------BBBBBBBBBBBBBBBBBBBBB?M?--
---------------------------------------------------BBB----------------------------------------------------------------------------------[]------------------------------------m----------------------------
------------------------------------------------------B----------------------------------------------------------------M----------------pP-----------------------------------m-----------------------------
----------------------------------------mm---------mm--B--------------------------------------------------------------------------mmm---pP-----------------------------------mgmmmmmmmmmmmmmmmmmmm---------
---------------------------------------mm-m-------mm-m--BB-mm-----------------------------------------------------------m--------mm[]mm???MBBBBBBBBBBBBBBBBBBBMB-------------m##B?BBBBBBBBBBBBBBB-m---?-??-
------------------------------mmm------m---m-----mm---m---mm-m----mmm---------------mm------K-------------------------mm-m------mm-pP--m------------------------------------m###-------------------m------?
------------------------------mC-m----mC----m----m-----m--m---m---mC-m-------mm----mC-m-------------------------------m#--m-----m--pP---m----------------------------------m####--------------------m------
--mmmmmmmmmmmmmmmmmmmmmmmmmmmm-c--mmmmmc-----mmmm-------mm-----mmm-c--mmmmmmmh-mmmmmc--mmmmmmmmmmmmmmmmmmmmmmmmmmmmmmm-#---mmmmm---pP----mmmmmmmmmmmmmmmmmmmmmmmmmmmmmmmmmm#####---------------------mmmmmm
##############################################[]#--------#------###########################################################################################################################################
