---------------------------------------------B##############------?----------------------------------------------------------#--#####----------------------------------------------------------------------
------------------------------------------------------------#----------------------------------------------------------------####################----#-----------------------------------------------------
-----------------------------------------------------------------------------------------------------------------------------------------------------------------------------------------------------------
--------------------------------------------------------------------#--------------------------------------------------------------------------------------------------------------------------------------
-----------------------------------------------------------------------------------------------------------------------------------------------------------------------------------------------------------
-----------------------------------------------------------------------------------------------------------------------------------------------------------------------------------------------------------
--------------------------------------------B-----------------------------------------------------------------------------------------m--------------mm----------------------------------------------------
-----------------------------------------mm------------------------------------------------------------------------------------------m-m------------m>-mmm-------------------------------------------------
----------------------------mmmmmmmmmmmmmmcm-----------------K-----#----------------------------------mm------mm--------------------m#+-m-----------m-----m------------------------------------------------
---------------------------m###############BmB-------------mm-----#----------------------------------mm-mmm--mm-m--------mm--------m##---m---------m?------m-----mm-----mm-----mm-----mm----------mm------m
--------------------------m################-Bm------------m##mmmm---mmm-----mm----mm----------------mm-----m-m---mmmm---mm-m------m###----m--------m--------m---mm-m---mm-m---mm-m---mm-m---mm---mm-m----mm
-------------------------m#################--------------m##-#mm-m--m#-mmm--m-m---m-m-----mm-m------m-------m------K-m--m---m----m####-----m-----mmM---------m--m---m--m---m--m---m--m---m--m-m--m---m---m-
--mmmmmmmmmmmmmmmmmmmmmmm##################--Bmmmmmmmmmmm###------mm-#----mm---mmm---mmmmm#-m-mmmmmm-------->---------mm-----mmmm#####------mmmmm??-----------mm-----mm-----mm-----mm-----mm---mm-----mmm--
############################################--##-#-#-#-#####-------#-------#----#######################----------------#------#-######-------##-#--------------#------#------#------#------#----#------##--
