----------------------------------------------------------------------------------------------------------------------------------------------#B-----------------------------------------------------------
----------------------------------------------------------------------------------------------------------------------------------------------pPBOB--------------------------------------------------------
----------------------------------------------------------------------------------------------------------------------------------------------pP----------------------------------------------------------m
----------------------------------------------------------------------------------------------------------------------------------------------V-----------------------------------------------------------m
--------------------------------------------h--h------------------m--------------------------------mm----------------------------------------------------------------------------------------------------m#
----------------------------------------BBBBBBBB----B------------m-m------------------------------mm-m----------------------?MM-M?-?M???M---------?M????------------------------------------------------m##
-------------------V---------------------B------BBBBB-----------m#B-m-----------------------m----mm---mmm-------------------------?---M-------mmm--------------------------------------mmmm---------mmmm###
-------------------[]------------------------------------------m##---m---------------------m-mm--m----[]-m------------------------------------m--m---------------mm--------------------m[]-m--------m######
--------------mmm--pP-------------------------h---------------m###----m-----------------mmmM---mm-----pP--mm--------------------------------------mmmmmmmmmmmmmmmk-mmmmmmmmmmmmmmmmmmmm-pP--mmmmmmmm-#-####
-------------mm[]mm?????-------------------*BBBBBBBBBBB-------m###-----m--------------mm??B----[]-----pP--M-m-------??M------------M??-------m--###########################################################
------------mm-pP--m---M?????M???---mmmm----------------------m###------m-------------m?-------pP-----pP----Vmm-----------------------------m#-------------------------------------------------------------
------------m--pP---mm--------------m[]-m--------------------m####-------mm-m--mm-m---m--------pP-----pP----[]-m---------------------------m##-------------------------------------------------------------
--mmmmmmmmmm---pP---k-mmmmmmmmmmmmmm-pP--mmmmmmmmmmmmmmmmmmmm#####-------#-m-mm#-m-mmm---------pP----#pP----pP--mmmmmmmmmmmmmmmmmmmmmmmmmmm#---------------------------------------------------------------
#################################################################################################-----######################################---------------------------------------------------------------
