--------------------------------------------------------Y--c------#####-------#----?---------#####----#---------------####----#################################--------------------------------------------
--------------------------------------------------###---y--C------------------#----------------########-#####################################################pP--------------------------------------------
-----------------------------------------------------####-##------------------#######-----------------##----------------------###########################V###pP--------------------------------------------
----------------------------------------------------------------------------------------------------------------------------------#######################V###pP--------------------------------------------
-----------------------------------------------------------------------------------------------------------------------------------######################[]##pP#-------------------------------------------
------------------BBBBBBBBBBBBB?M?--------------------------------------------------------------------m-m--------------------mm-m---#####################pP##pPpP--#---------------------------------------
---------------m------------------------------------------------------------------------------------mmmm--------------------mm-m-mmm-#####################--#pPpP------------------------------------------
----------------m--------------------------------mm---------------------------m--------------------mmB-B-m-----------------mm----###m---------------------mm-##pP------------------------------------------
---------------m#mmmmmmmmmm---------------------mm-m--m------------B----------mmm------------------m------m--------------mmm-----####mmmmmmmmmmmmmmmmmmmmm##m--pP-----------mm---------mm---------mm-------
--------------m##BBBBBBBBB-m--??M?M---mm--------m---mm-m-mm-----mm------mmmm-m-C-m----------------m--------m-------------mC------############################mm###---------mm-mmm-----mm-mmm-----mm-mmm----
-------------m###-B---------m------M-mm-m----mmm-----OB-mm-m---mm-m-----mmm-mB-c--m----mm--------m#---B------------------mc------##############################m----------mm-----m---mm-----m---mm-----m---
------------m####------------m-------m---m---m[]----O--MM---m--m---m--mm----B--c------mm-mmm----m##---------m-----------m##-----###############################--m--------m-------m--m-------m--m-------m--
--mmmmmmmmmm#####-------------mmmmmmm-----mmm-pP-------------mm-----mm##-------#---mmmm-----mmmm###----------mmmmmmmmmmm###-----################################m-mmmmmmmm---------mm---------mm---------mm
#####################################------######-----------C-#----#-#-#-------c----##-------#-####----------#-#-#-#-######-----###############################-#-#########---------##---------##---------#
