--------------------------------------------------------------------------------#-------------###########--------------------------------------------------------------->##########------------------------
---------------------------------------------------------------------------------####----------------------------------------------------------------------------------------------#-----------------------
---------------------------------------------------------------------------------------------------------m--------------------------------------------------------------------------#----------------------
----------------------------------------------------------------------------------------------------------m------------------------------------------------------------------------------------------------
-----------------------------------------------------------------------------------------------------------m-----------------------------------------------------------------------------------------------
-----------------------------------------------------------------------------BB?B----------------------mm---m----------------------------------------------------------------------------------------------
---------------------------------------------------------------------------mm----B--h--B-------------mm##----m----------------------------------------mm------------------------mmmmm----------------------
----------------------------------------------------------mm--------------mm-mm---BBBBB--------------m###-----m--------------------------------------mm-mmm-------------------mm#??B--------------mm-------
----------------------------------------------mm---------mm-m------------mm----mm------mm-----------mC###------m--------------------------------mm--mm-----m-------------------##----m-----------mm-mmmm---
---------------------------------------------mm-m--------m---m-----------m----???m-----m-m----------m####-------m------------------------------mm-mmm-----K-mm------mm--------m##-----m---------mm---->-m--
-------------mmm------------mm---------------m---m-----mm-----mmm------mm----B--??mmmmm---mm-------m#####--------m----------------------------mm------------K-m----mm-m------m###------m--------m--------m-
-------------mC-m------K---mC-m---K---------mC----m----mC-----[]-m-----mC----B----????B-----m-----m######---------mm-m---------------mm-m-----m----------------mm--m---m----m####-------mmmmmmmm----------m
--mmmmmmmmmmm-c--mmmmmmmmmmmc--mmmmmmmmmmmmmmC-----mmmm-c-----c---mmmmm-c----B---------------mmmmm#######---------#-m-mmmmmmmmmmmmmmm#-m-mmmmm-----------------B-mm-----mmmm#####-------########-----------
#################################################---#############################-------------##-########-########################################----------------#------#-######-------------------------#
