-----------------------------------------------###########################-----------------------------------------------------------------------?-----------------------------------------B?--------------
--------------------------------------------------------------------------#-------------------------------------------------------------------m--m-mmm---------------------------------------B-mm----------
---------------------------------------------------------------------------#-----------------------------------------------------------------m-mm-mmm-m-----------------------------------mm--mm-m---------
-------------------------------------------------------------------------------------------------------------------------------------------mmBB?B??-K--mm--------------------------------mm?mm?---mmm----mm
---------------------------------------------------------m--------------------------------------------------------------------------------mmB------------m--------------mmm---------------????-------m--mm-
-------#??M?M?M?-------------------------------------mmmm-----------------------------------------------------------------BBB------------mm---------------m-------------m?-m-------------m---?--------m-m--
-------#---------------------------------------------mg#B-m------------------------------------------------------------------------------m-----------------m------------m---m------------m-------------m---
-------#---------------------------------------------m##?--m----------------------------------------------------------------------------m-------------------mmmmmmmmmmmm-----mmmmmmmmmmmm--------------#---
-------#k----h----------------------------mm--------m###----m--------------------------mm-------------mm---------------mm--------------m##-----------------##################################--------------
-------#????B?M?M?----------------mm-----mm-m------m####-----m------------------------mm-mmm---------mm-mmm-----------mm-mmm----------m##-----------#-------------------------------------------#----------
--------------------------mmm----m#-m----m---m----m#####------m----------------------mm-----m-------mm-----m---------mm-----m--------m###------##----------------------------------------------------------
--------------------------m#-mmmmm#--mmmm-----m--m######-------m---------mm--mmm-----m-------m------m-------m--------m-------m------m####------------------------------------------------------------------
--mmmmmmmmmmmmmmmmmmmmmmmm-#-############------mm#######--------mmmmmmmmm#-mmmm-mmmmm---------mmmmmm---------mmmmmmmm---------mmmmmm#-###--------------#---------------------------------------------------
############################--------------------#-######--------#-#-#-#-#---#------##----------#########------#######----------##########------------------------------------------------------------------
