-------------------------------------------------------------------------------------#########[]-----##----------------------------------------------------------------------------------------------------
---------------------------------------------------------------------------------------------##------###################-----------------------------------------------------------------------------------
--------------------------------------------------------------------------------------------------------------------------------------------------------------------------------------#--------------------
---------------------------------------------------------------------------------------------m--m----------------------------------------------------------------------------------------------------------
--------------------------------------------------------------------------------------------mmmm-m---------------------------------------------------------------------------------------------------------
---------------------------------------------------------------BBBB----BBB--------B---------mg#?--m--------------------------------------------------------------------------------------------------------
-------------------------------------M------------------------B---BBBBB+------------------mm###----m-------------------------------------------------------------------------------------------------------
-------------------------------------------------------------------------------------------g###-----m------------------------------------------------------------------------------------------------------
---------------------m--------------------------------------------h-------------mm--------m####------m--------------------mm---------mm---------mm------------------mm---------mm-----------mm-----------mm
--------------------m-m-------------K-----------------------mmmmBBBBB--mmm-----mm-m------m#######-----m------------------mm-mmm-----mm-mmm-----mm-mmm------mmm-----mm-mmm-----mm-mmm-------mm-mmm-------mm-
----------mmm------mC--m------------------mmm--------------mmB--m-----m[]-m---mm---m----m######-------------------------mm-----m---mm-----m---mm-----m-----mC-m---mm-----m---mm-----m-----mm-----m-----mm--
----------mC-m-----mc---m------------K-----C-m-------------mK----m----mpP--m--m---#-m--m#######--------mm---------------m-------m--m-------m--m-------mmmmm-c--m--m-------m--m-------m----m-------mm---m---
--mmmmmmmm-c--mmmmmmc----mmmmmmmmmmmmmmmmmmc--mmmmmmmmmmmmm-------mmmmmpP---mm----#--mm########--------#-mmmmmmmmmmmmmmm---------mm---------mm--------#######---mm---------mm---------mmmm--------K-mmm----
####################################################################################--#########V-------#-#-#-#-#-#-#-#-#----------#----------#-------------------#----------#----------#-#-----------##----
