--------------------------#--------------------#########--------------#------------------------------------------------------------------------------------------------pP-------------#####################
--------------------------------------------------------#--------------------------------##----------------------##----------------------------------------------------pP----------------------------------
-----------------------------------------------------------------------------------------------------------------------------------------------------------------------pP----------------------------------
-----------------------------------------------------------------------------------------------------------------------------------------------------------------------########----------------------------
------------------------------------------------------------#V----Y----------------------------------------------------------------------------------------------------------------------------------------
--------------------------V-----------------BBBB------------------y----------------------------------------------------------------------------------------------m-----------------------------------------
------------------------VB[]-----------------BpPO------------######---------------------------------------------------------------------------------------------m-----mmm----------------------------------
------------------------[]pP------------------pP----------mm-------#--------------------------------------------------------------------------------------------mC---mm--m---------------------------------
------------------mmm---pPpP------------------pP-----m---mm-m-------#--------------mm-----------mm----------mm------------mm-----------------------mm-----------mcmmmm----m--------------------------------
-----------------mm[]mmm?-B?M???--------------pP----m#mmmm---m------------mm------mm-mmm-------mm-mmm------mm-mmm--------mm-mmm--------------------mmmm--------m###BB---V--m-----mm--------mmmmmm----------
----------------mm-pP-B--?-m----????----------[]---m##??M-----m---m--#---mm-mmm--mm-----m-----mm-----m----mm-----m------mmY----m-----mmm---------Km--#-m------m####-----[]--m---mm-mmm----m#####-m---------
----------------m--pP---m---------------------V---m###---------m-mmm-----m-----m-m-------m----m-------m---m-------m-----m-y-----m----mB-m--------m#--#--m----m#####-----pP---m--m-----m--m######--m--------
--mmmmmmmmmmmmmm---pP----mm-mmmmmmmmmmmmmmmmmmmmmm####----------mm--mmmmm-------m---------mmmm---------mmm---------mmmmm--#------mmmm----mmmmmmmmm#--#---mmmm######-----pP----mm-------mm#######---mmmmmmmm
#####################----######################-######----------MMK-#-#-##------#----------#-#---------######-------#######-------####################---###########----pP-----#--------########----#-#-#-#
