----------------------------------------------------------------------------------#-------------------------B----------------------------------------------------------------------------------------######
-----------------------------------------------------------------------------------------------------------------------------------------------------------------------------------------------------------
-----------------------------------------------------------------------------------------------------------------------------------------------------------------------------------------------------------
-----------------------------------------------------------------------------------------------------------------------------------------------------------------------------------------------------------
-----------------------------------------------------------------------------------------------------------------------------------------------------------------------------------------------------------
-----------------------???-M-----------------------BBBBBB-------------------------B-BBBBBBBMB?????M?M---------------m--------------------[]---------------------------------BBBBBBBBBBBBBBBBBBBBBBB--------
--------------------------?-?-----------#-----------B----B-------------------------B-------------------------------m-mmm-----------------pP----------------------------------------------------------------
--------------------------------------------------B---------------------------------h------------------------------mg#B-m----------------pP----------------------------------------------------------------
-----------------mmm---k--------------------------M----------------------mmmmmmmmmm-B------------------------------m##---m---------mmm---pP--------------------------------mmmmmmmmmmmmmmmmmmmmmmm--------m
----------------mm[]mm???B??-?--------------------mBBBBBB---mm------------#########m---OBBBBBBBB??????--mm--------m###----m-------mm[]mm?M??--------------------------------M????????????????????-m------m#
---------------mm-pP--m--?M???M?????---mmmm------mmm-------m#-m----------m########-#mm-----------------mm-m------m####-----m-----mm-pP--m--------mmmm----mmmm--------------m-----------------------m----m##
---------------m--pP---mm--------------m[]-m-----m--m------m#--m---mm---m#########----m----------------m---m----m#####------m----m--pP---m--mm---m[]-m---m[]-m-------------m------------------------m--m###
--mmmmmmmmmmmmm---pP---g-mmmmmmmmmmmmmm-pP--mmmmm-B--mmmmmmm#---mmmh-mmmm#########--#--mmmmmmmmmmmmmmmm-----mmmm######-------mmmm---pP----mmk-mmm-pP--mmm-pP--mmmmmmmmmmmmm--------------------------mm####
###################################################################################--##################------#######################################################################################--#####
