--------------------------------------------------------------------------------------------------------------------------------------------------?########################################################
-------------------------------------------------------------------------------------------------------------------------------------------#------#--------------------------------------------------------
-----------------------------------------------------------------------------------------------------------------------------------------------------------------------------------------------------------
----------------------------------------------------------------------------------------------------------------------------------------------------------------------------------------------------------m
---------------------------------------------------------------------------M----------------------m-------------------------------------------------------------m-----------------------------------------m
-------------------------------------------------------------------------------------------------m-m----------------------------------------------------------mm-m---------------------------------------m-
-------------------m---B----------------------------------------------------m--------------------mC-m--------------------------------------------------------m##--m-----------------------------------mmmB-
--------------------m--------------------------mm--mmm----------------------mmm------------------mc#-m--------mmm-------------------------------------------m###---m----------------------------------mg#--
-------------------mCmm-B---------------------mm-mmBB-m--------m----------mm-?-m----------------m###--B------mm[]mmB??M?-------------mmm-------------------m####----m--------------------------------m###--
------------------m###Bm---------------------mm---B----m------m-m---------m#----m-m------------m####--m-----mm-pP--m-?-??-----------mm[]mm----mm----------m#####-----m------------------------------m####--
-----------------m####-Bm------mm-----m------m--------B-mmmmmmk--mmmmmmmmm-#-----mmm----------m#####---m----m--pP---m----??MM??----mm-pP--m--mm-m--------m######------m----------------------------m#####--
----------------m#####---------m-m---m-mm---m-----------#####################----B--mmmmmmmmmm######----mmmm---pP----mmm-----------m--pP---m-m---m------m#######-------m---mm----------------m----m######--
--mmmmmmmmmmmmmm######---mmmmmm---mmmk-k-mmm#--------------------------------#-----#####################################mmmmmmmmmmm---pP----m-----mmmmmm########--------mmm#-mmmmmmmmmmmmmmmm-mmmm#######--
#######################---#####----##########---------------------------------------------------------------------------################----#------#k-##########--------#-#---#-#-#-#-#-#-#-#--##########--
