--------------------------------------------------------------------------------------------------------------------?--B----------------------------------------------------------------------#############
-------------------------------------------------------------------------------------------------------##----------mm---BB----------------------------------M---------------------------------#############
------------------------------------------------------------------------------------------------------------------mm-mmm----------------------------------------------------------------B------------------
-----------------------------------------------------------------------------------------------------------------mm--[]-m----------------------------------------------------------------B-----------------
---------------------------------------------------------------------------------------------------------------------pP--m----------------------------------------------------------------B----------------
--------------------------------------------------------------------------m---------------BBBBBBB??--------------m---pP---m-----------------------------------------------------------mm---B---------------
----------------------------------[]-------------------------------------m-m------------------------------------m#---pP----m---------------------------------------------------------mm-m---BBB------------
----------------------------------pP-------------------------------------mV-m-----------------------------------m#---pP-----m--------------------------------------------------------m---m-----------------
----------------------------mmm---pP----------h----------------------mmmm-[]-m------------mmm------------------mm#--###------mmmmmmmmmmmmmmmmmmmmmmmmmmmmmmmmmmmmmmmmmmmmmmmmmmmmmmmm-----m----------------
---------------------------mm[]mm??-BBBMBBBBBBBBBBBBB?M#-------------m??M-pP--m----------mmB-m--???M-----------m?---------###########################################################------m---------------
--------------------------mm-pP--m---------------------??M-----------m----pP---m--------mmY---m------mm------mm-----------------------------------------------------------------------------m-------mmmmmmm
--------------------------m--pP----mm--------------------------------m----pP----m-------m-y----m----mm-mmm---m#------------------------------------------------------------------------------m-----m#######
--mmmmmmmmmmmmmmmmmmmmmmmm--KpP---m--mmmmmmmmmmmmmmmmmmmmmmmmmmmmmmmm-----pP-----mmmmmmm--pP----mmmmm-----mmm-#-------------------------------------------------------------------------------mmmmm########
###############################----#################################################################-------####--------------------------------------------------------------------------------############
