--------#-?----------------------###----pP-------------------------------------------######################################################################################################################
---------------------------------------#pP-----------------------------------------------------############################################################################################################
----------------------------------------#####---------------------------------------------------###########################################################################################################
-------------------------------------------------------------------------------------------------##########################################################################################################
----------------------------------------------------------------------------------------------mm-##########################################################################################################
------------------------------B------------------------------------------------B--------------m#m-#########################################################################################################
-------------------------------------BBB-----------------------------------------------------m###m-########################################################################################################
------#-----------------------m------mmBB--------------------------------------m------------m#####m-----------------------------------#####################################################################
------#k--------------------mm-mmmmm-m-m-------------------------------------mm-mm---------m#######mmmmmmmmmmmmmmmmmmmmmmmmmmmmmmmmmmm-####################################################################
------#BM------------------mmB-----Vm---mm--------------------m--------------mB---m-------m###########################################m-###################################################################
--------------------------mm----B--[]-----m----mm----------mmm-m----------mmm------m-----m#############################################m-------------------------------------------------------------------
------------mm------------m--------pP------m--mm-mmm-------m[]--m-----mm--m[]-------m----###############################################mmmmmmmmmmmmmmmmmmmmmmmmmmmmmmmmmmmmmmmmmmmmmmmmmmmmmmmmmmmmmmmmmmm
--mmmmmmmmmmg-mmmmmmmmmmmm---------pP-------mmm-----mmmmmmm-pP---mmmmmh-mm-pP--------mmmm##################################################################################################################
##########-###################-----pP----[]--#-------##########################--#----#-###################################################################################################################
