------------------------------------------------------------------#------##############################################-------?----------------------------------------------------------------------------
-----------------------------------------------------------------------------------------------------------------------------------------------------------------------------------------------------------
-----------------------------------------------------------------------------------------------------------------------------------------------------------------------------------------------------------
-----------------------------------------------------------------------------------------------------------------------------------------------------------------------------------------------------------
-------------------------------------------------------------------------------------------------------------------------------?---------------------------------------------------------------------------
-----------------------------------------------------------B------B----------------------------------------------------------------------------------------------------------------------------------------
-------------------------------------------------------------------BBBB-------------------------------mm---------------------------------------------------------------------------------------------------
---------------------------------------------------------BB----B-----B-B----------mmm----------------m#-m-------------------#--#---------------------------------------------------------------------------
-----------------------------------------------------mmm--------BB---B--B--------m#B-m--------------m##--m-------------------#-------------------m---------mm---mm-----------------------------------------
------------------K----mm-------------------------K-mm[]m--B-mm--BB-mm---B------m##---m------------m###---m------------mm-----#-??---------------mm-------mm-mmmm-m----------------------------------mm---m
----------mmm---------mC-m-------------------------mm-pP-m--mm-m---mm-m--------m###----m----------m####----m----------mm-mmm-------------------mm--m-----mm----K---m----mm--------------------------mm-m--m
----------mC-m--------mc--m------------------------m--c ----m---m--m---m------m####-----m--------m#####-----m-----m--mm-----m-----m--mm-m------m#---mm---m----------m---m-m-------mm----------------m---mm-
--mmmmmmmm-c--mmmmmmmmmc---mmmmmmmmmmmmmmmmmmmmmmmm---# --mm-----mm-----mmmmmm#####------mmmmmmmm######------mmmmm-mm#-------mmmmm-mm#-m-mmmmmm-#---#-mmm------------mmm---mmmmmmmk-mmmmmmmmmmmmmmmm---->>-
########################################################---#------#------#-#-######-------#-#-#-#######------#-#-#--#--------#-##################------##-------------##---#########################-------
