---------------------------------------------------------------------------------------------------------------------------------------------------------##################################################
--------------------------------------------------------------------------------------------------------------------------------------------------##-------------------------------------------------------
-----------------------------------------------------------------------------------------------------------------------------------------------------------------------------------------------------------
-----------------------------------------------------------------------------------------------------------------------------------------------------------------------------------------------------------
----------------------------------------------------------------------------------------------------------------------------------------------------------------------------------------------------------m
-------------------------------------------------------------------------------------------------------------------------[]-----------------------------------------mm----------------------------------mm-
-------------------------------------------------------------------------------------------------------------------------pP-------------------------------------m--mm-mmm------------------------------m##-
-------------------------------------------------------------------------------------------------------------------------pP------------------------------------m--mm-----m----------------------------m###-
------------------------------------------------------------mm--------------------mmm------------------------------mmm---pP------------------------------------m--m-------m--------------------------m####?
------------------------------------------m----------------mmYm------------------mm[]mm---------------------------mm[]mm???M??---mm-------------------mm-------mkm---------m------------------------m#####-
--------------------------mmm----mmm-----m#m--------------mm-y-m----mm---------Kmm-pP--m----?????????????????----mm-pP--m-------mm-m----------mmmm---mm-m-----m###----------mmm--------------------m######-
--------------------------mC-m---mC-m----m#-m-------------m--#--m---m-m---mm----m--pP---m------------------------m--pP---m------m---m---------m[]-m--m---m---m####----------[]-m------m--------m--m#######-
--mmmmmmmmmmmmmmmmmmmmmmmm-c--mmm-c--mmmmm#--mmmmmmmmmmmmm---#---mmm---mmmh-mmmm---pP----mmmmmmmmmmmmmmmmmmmmmmmm---pP----mmmmmm-----mmmmmmmmm-pP--mm-----mmm#####----------pP--mmmmmm-mmmmmmmm-mm########-
##############################################################----##############################################################----#############---#-----#-######----------pP---#-#-#--#-#-#-#--#########-
