------------------------------------############################################################--------------##################---------------------------------------------------------------------------
-----------------------------------------------------------------------------------------------------------------------------------------------------------------------------------------------------------
-------------------------------------------------------------------------------------------------------------------------------------------------------##--------------------------------------------------
--------------------------------------------------------------------------------------------------------------------------------mmm------------------------------------------------------------------------
------------------------------------------------------------------------------------------------------------------------------mm---m--#--------------------------------------------------------------------
------------------------------------------------------------------------------------------------------------------------------m#----m--#####---------------------------------------------------------------
------------------------------mm----------m----------------------------------------------------------------------------------m##-----m---------------------------------------------------------------------
-----------------------------mm-m--------m-------------------------------------------------------m----#--------------------mm###------m---------mm---------------------------------------------------------
-----------------mm---------mm---m-------m-m---------------------------------------------------mmmm-------------------------####-------m-------mm-mmm---------mm---------mm-------------mm-----------------
-----#M???????--mm#m-------mm-----m------mg-m--------------mmm--------------------------------m##--m-----------------------m####--------m-----mm-----m-------mm-mmm-----mm-mmm---------mm-mmm-----mm-------
---------------mm-#-m-----mmY----B-m----m###-m------------m##-m------------------------------m#####-mm------mm------------m#####---------m----m-------m-----mm-----m---mm-----m-------mm-----m---mm-m-----m
---------------m--#--m---mm-y-------m--m####----------m--m###--m--------mm---------mm-------m###------m--m--m-m----mm----m######----------m--m---------m----m-------m--m-------m------m-------m--m---m----m
--mmmmmmmmmmmmm---#---mmmm--#--------mm#####--mmmmmmmm-mm####---mmmmmmmm#-mmmmmmmmm#-mmmmmmm####-------mm-mm---mmmm#-mmmm#######-----------mm#----------mmmm---------mm---------mmmmmm---------mm-----mmmm-
#############################---------######---#-#-#-#--#####----#-#-#-#--#-#-#-#-#--#-#-#-#####-------##--#----#-#---#-########------------#------------#-#----------#---------#########-------#----->>>>-
