---------------------#---?---------------------########---------------------------------------------###########-----------------------------------?#######-----------###-----------------------------------
----------------------#------------------------########-##----------------------------------------------------------------------------------------#------------------###-----------------------------------
-----------------------#####-------------------#########--#------------------------------------------------------------------------------------------------------#######-----------------------------------
----------------------------##########---------------------###-------------------->----------------------------m-------------------------------------------------#######-----------------------------------
---------------------------------------------------------mmm##-----------------------------------------------mm-m-------------------------------------------mm--########-----------------------------------
---------------------------------------------------------mmmm----------------------m-------------------------mm--m-----------------------------------------mm-m-########-----------------------------------
--------------------------------------------------------m-------------------------m-mmm---------------------m-#---m----------------------------------------m---m-###########-------------------------------
-------------------------------------------------------m?------------------------mm----m--------------------m##----m------------------------------------mmm-----m------------------------------------------
-------------------mm---+-----------------------------m#-----m--------mm----mm--mm------m------------------m###-----m-----------------mm-----------------g#-------------------------------mm-------------mm
------------------mmVm----B-BBBBBBBBBBBBBB-mm--------m##------mm------m-m---m-m-m--------m------mm--------m####------m---------------mm-m-----mm--------m##------m---------------mm------mm-mmm---------mm-
---------mmm-----mm-[]m-------------------mm-m------m###--------m----mY--mmm---m----------m----mm-m------m#####-------m--------------m---m---mm-m------m###-------m------m------mm-m----mm-----m-------mm--
---------m#-m----m--pP-m---m--------------m---m----m####---------m--m#y----######----------m---m---m----m######--------mmmmmmmmmmmmmm-----m--m---m----m####--------m--mmm-m--m--m---m---m-------m------m---
--mmmmmmm-#--mmmm---pP--mmm?mmmmmmmmmmmmmm-----mmmm#####----------mm#-#---------------------mmm-----mmmm#######--------##############------mm-----mmmm#####---------mm###--mm-mm-----mmm---------mmmmmm----
######################--#-#?????BBBBB-#?-#------########-----------#####---------------------##------#-########-----------------------------#------#-######----------####---#--#------##----------########-
