------------------------------------------------------------------------------------------------------------------------------------------------------------------------------------#######################
-----------------------------------------------------------------------------------------------------------------------------------------------------------------------------------------------------------
-----------------------------------------------------------------------------------------------------------------------------------------------------------------------------------------------------------
-----------------------------------------------------------------------------------------------------------------------------------------------------------------------------------------------------------
-----------------------------------------------------------------------------------------------------------------------------------------------------------------------------------------------m-----------
---------------------------------------------------------------------------------------------------------------------------------------------------------------------------------------------mm-m----------
------------------------------------------M---M---------------------------------------------------------------------------------------------------------------------------------------------m##--m---------
-------------------------------------------------------------------------------------------------------------------------------------------------------------------------------------------m###---m--------
---------------------------------------------?------------------mm--------mm----------------------------------------mm-mmmmmmmmm----------------------------------------mmmmm-------------m####----m-------
---------------------------mm--------------??-----------mm-----mm-mmm----mm-mmm------------------------------------mm-m---------mm-------------------------------------mmB---m-----------m#####-----m------
----------------mmm-------mC-m-------------------------mC-----mm-----m--mm--[]-m--------??????--------------------mm--B---B-----B-m---mmm---------------mmm-----------mm--B---mmm-------m######------m-----
----------------mC-m------mC--m------------------------mC-m---mC------m-m---pP--m-----------------------mm----mm--m---------B------m--mB-m--------------m#-m----------m-------BB-mm----m#######-------m----
--mmmmmmmmmmmmmm-c--mmmmmmmC---mmmmmmmmmmmmmmmmmmmmmmmmmc--mmm-c-------m----pP---mmmmmmmmmmmmmmmmmmmmmmmh-mmmmh-mm--K---------------mm----mmmmmmmmmmmmmm-#--mmmmmmmmmm-----------B-mmmm########--------mmmm
######################################################################-##############################################----------------#####################################------B---#-#########--------#-#-
