----------------------------###############--------------------------------------------------------------pP---------------------------##################pP------------------#------------------------------
------------------------------------------------#######--------------------------------------------------###-----------------------------------------########################------------------------------
-----------------------------------------------------------------------------------------------------------------------------------------------------------------------------------------------------------
-----------------------------------------------------------------------------------------------------------------------------------------------------------------------------------------------#-----------
-------------------------------------------------------------------------------------------------------------------------------------------------------------------------------------------#----####---#---
------------------------------------------------------------------------------------------------------------------------------------BB---------------------------------------------------------------------
----------------------------V---------------B-----------------------------------mmmm------------------------------------V-----------mmB-----------------mmmm-------------------------------m---------------
----------------------------[]-------------------------------------------------m#?B-m-----------------------------------pP----------m-m----------------m#[]-m-----------------------------m-mmm------------
-----------------------mmm--pP------------------------------mm----------------m##----m-------------mm--------------mmm--pP-------mmm---m--------------m##pP--m---------------------------m#----m-----------
----------------------mm[]mmM?----------mmmmmmm------------mm-mmm------------m###-----mmm---------mm-mmm----------mm[]mm??------mm[]----m-----------mm###pP---m-------------------------mm------m-----mm---
---------------------mm-pP--m-?????----m###BBB------------mmY----m----------m####-----BB---------mm-----m--------mm-pP--m------mm-pP-----m---------m[]###pP----m------------mm----------m--------m---mm-mmm
---------------------m--pP---m-----m--m####----m--mm------m-y-----m---m-m--m#####--------mmm-----m-------m-------m--pP---------m--pP------m----m--m#pP###pP-----m----------mm#mmm------m----------m--m-----
--mmmmmmmmmmmmmmmmmmm---pP----mmmmm-mm#####-----mmm-mmmmmm--#------mmm-m-mm#-####--------BB-mmmmm---------mmmmmmm---pP---mmmmmm---pP-------mmmm-mm##pP###pP------mmmmmmmmmmm-#---mmmmmm#-----------mm------
#############################-k-#-#--######------#---#-#-####-------##-#-########------------########-----[]-#######################--------#-#--###pP###pP-------#-#-#-#-#--#----#######-----------#------
