--------------------------------------------------------------------------------####################################################################-----------#######################---------------------
----------------------------------------------------------------------------------------------------------------------------------------------------mm-----------------------------------------------------
------------------------------------------------------------------------------------------------------------------------------------------------------m----------------------------------------------------
----------------------------------------------------------------------------------------------------------------------------------------------------?--m-------------------------------------m-------------
--------------------------------------------------------------------------------------------------------------------------------------------------m-----m---------------------------------mmm-m------------
----------------------------------------------------------------------------------------------mm-------------------------------------------------mmm-----m-------------------------------m###--m-----------
----------------------------------------M----------------------------------------------------m#-m------------------------------------------------mg#------m-----------------------------m####---m----------
----------------------------------------------------mmm-------------------------------------m##--m-----------------------------------------------m##m------m---------------------------m#####----m---------
-------------------------------------------------mmm---mm---------------mmm----------------m###---m---------------------------------------------m####-------m-------------------------m######-----m--------
----------------------------------------mm------mmBB---B-m-------------mm[]mm--??---------m####----m-------------------------------------------m####---------m-----------------------m#######------m-------
-------------------------------mmm-----m#-m----mm---------m-----mmm---mm-pP--m--??-------m#####-----m-----------------------------------------m#####----------m---------------------m########-------m------
-------------------------------mC-m----m#--m---m-----------m----mC-m--m--pP---m---------m######------m----m-----------m------------m----m----m######V ---------m-------------------m#########--------mm-m--
--mmmmmmmmmmmmmmmmmmmmmmmmmmmmm-c--mmmmm#---mmm-------------mmmm-c--mm---pP----mmmmmmmmm#######-------mmmm-mmmmmmmmmmm-mmmmmmmmmmmm-mmmm-mmmm#######[]----------mmmmmmmmmmmmmmmmmmm##########--------#-m-mm
###################################################----------#####################-#-#-########--------#-#---#-#-#-#-#--#-#-#-#-#-#--#-#--#-########pP----------#-#-#-#-#-#-#-#-#-####-####################
