-----------------------------------------------------------------------------------------------------------------?-------------------------------------------------------------------------------[]--------
-------------------------------------------------------------------------------------------------------------------------------------------------------------------------------------------------pP--------
----------------------------------------------------------------------------------------------------------------------------------------------------------------#############################----pP--------
--------------------------------------------------------------------------------------------------------------------------------m--------------------------------------------------------------#-pP--------
---------------------------------------------------------h----h----------------------------------------------------------------m-m--------------------------------------------------------------###--------
--------------------------------------------------------BBBBBBBBBBBBBBBBBBBBBBBB---------------------BBBBBBBBM?---------------mB--m--------------------------------------------------------------------###-
------------------------------------------------------------------------------------------------------------------------------m----m-----------------------------------------------------------------------
-----------------------------------------------------------------------------------------------------------------------------m#-----m----------------------------------------------------------------------
-----------------mmm----------------------------------mmmmmmmmmmmmmmmmmmmmmmm----------mm----------mm-----------------------m##------m-------mmm----------mmmm----------??BBBBBBBBBBBBBBBBBBBB-------------
-----------------mM-m--------------------------------m?????????????????????B-m--------mm#mm-------mm#mmBBBBBBBBB-----------m###-------m-----mm[]mm-------mm[]-m-------------------------------B------mm----
---------------mm----m------------------mm----------mC------------------------m------mm-#--m-----mm-#--m-----------------mmh###--------m---mm-pP--m-----mm-pP--m------------------------------------mm-m---
---------------mC-----m----mm----------mC-m---------m?-------------------------m-----m--#---m----m--#---m-------K--------m#####---------m--m--##---m----m--pP---m----mmmmmmmmmmmmmmmmmmmmmm--mm-----m---m--
--mmmmmmmmmmmmm-c------mmmmh-mmmmmmmmmmmC--mmmmmmmmmm---------------------------mmmmm---#----mmmm---#----mmmmmmmmmmmmmmmm--####----------mm---##----mmmm---pP----mmmm?????????????????????-mm#-mmmmm-----mm
#################################################################################################################-###########################################-----#-#-----------------------#-----##------#
