-------------------------------------------------------------------------------------------------------------------------------------------------------------##############################################
-----------------------------------------------------------------------------------------------------------------------------------------------------------------------------------------------------------
-----------------------------------------------------------------------------------------------------------------------------------------------------------------------------------------------------------
-----------------------------------------------------------------------------------------------------------------------------------------------------------------------------------------------------------
-----------------------------------------------------------------------------------------------------------------------------------------------------------------------------------------------------------
-----------------------------------------------------------------------------------------------------------------------------------------------------------------------------------------------------------
-------------------------------------------------------------------------------------------------------------------------------------------------------------------m---------------------------------------
------------------------------------------------------------------------------------------------------------------------------------------------------------------m-mmm------------------------------------
---------------------------------------------------------------------------------------------------K----------------------------------------------------m---------mg#B-m-----------------------------------
----------------------------------------------------------------------mm------?????---------------mmm--------------------------------------------------mmm--------m##---m---------------------------------m
---------------------------------------mmm---------------------------m?-m-------------------------m?-m---Kmm----------K--------------------------------m--m------m###----m-------------------------------m#
---------------------------------------mC-m--------------------------mC--m------------K-----------m---m--mC-m------------------------------mm---------mC---m----m####-----m--------------mm----------m--m##
--mmmmmmmmmmmmmmmmmmmmmmmmmmmmmmmmmmmmm-c--mmmmmmmmmmmmmmmmmmmmmmmmmmmc---mmmmmmmmmmmmmmmmmmmmmmmm-----mmmc--mmmmmmmmmmmmmmmmmmmmmmmmmmmmmmh-mmmmmmmmmmc----mmmm#####------mmmmmmmmmmmmmm#-mmmmmmmmmm-mm###
##########################################################################################################################################################---#-######-------#-#-#-#-#-#-#---#-#-#-#-#--####
