---------------------------#----------####---------------------------------------------------------------------------------------------------------------------->##########--------------------------------
----------------------------##--------###------------------------------------------------------------------------------------------------------------------------------------------------------------------
------------------------------#------###V------------------------------------------------------------------------------------------------------------------------------------------------------------------
-------------------------------#-----####-#--------------------------------------------------------------------------------------------------------------------------------m-------------------------------
--------------------------------#---####pP-####--------------------------------------------------------------------------------------------------------------------------mm-m------------------------------
---------------------------------#######pP-------------------------------------------------------------------------------------------------------------------------------mg--m-----------------------------
-------------------------m---------#######------------------------------------------------------------------------------------------------------------------------------m##---m----------------------------
------------------------m#m----------------------------------------------------------------------------------mm-----mm--------------------------------------------------m##----m---------------------------
-----------------------m##-m--------------m------------mm-------------------------------mm--------------mm--mm-m---mm-m------------------------------------------------m###-----m--------------------------
----------------------m###--mK-mm----------m-----------m-m-----mm-------mm-----mm------mm-mmm----------mm-mmm---m--m---m-------mm------mm-----mm-----mm-----mm--------m####------m-------------------------
---------------------m####--?mmm-m-------m--m---mm---mm---m---mm-mmm---mm-m---mm-m----mm-----m--------mm---------mm-----mmm---mm-m----mm-m---mm-m---mm-m---mm-m------m#####-------m------------------------
--------------------m#####---??---mm----m#---m--m-m--m#----m--m-----m--m---m--m---m---m-------m-------m---------->>----->>-m--m---mm--m---m--m---m--m---m--m---m----m######--------m----------------K------
--mmmmmmmmmmmmmmmmmm######----------mmmm##----mm---mm-------mm-------mm-----mm-----mmm---------mmmmmmm----------------------mm------mm-----mm-----mm-----mm-----mmmm#######---------mmmmmmmmmmmmmmmmmmmmmmm
############################-----------###-----#----#--------#--------#------#------##----------#########--------------------#-------#------#------#------#------#-########-###############################
