---------------------------------------------------------------------------------------------------------------------------###############################---------?---------------------------------------
----------------------------------------------------------------------------------------------------------------------------------------------------------#----------------------------------------#-------
-----------------------------------------------------------------------------------------------------------------------------------------------------------#-----------------------------------------------
---------------------------------------------------------------------------------------------------------------------------------------------------------mm-#----------------------------------------------
--------------------------------------------------------------------------------------------------------------------------------------------------------mm---#---------------------------------------------
-------------------------------------------------------------------------------------------------------------------------------------------------------mm--m--#--------------------------------------------
------------------------------------------------------------------------------------------------------------------------------------------------------mm-------#-------------------------------------------
------------------------------------------------------------------------------------------------------------------------m----------------------------m#-----m---#-#---m-m----------------------------------
---------------------------------------------------------------------m-mm-----------------------------------------------mmm-------------------------m##------m------##-m-m---------------------------------
--------------------------------------------mm--------------------K---mC-m------------------------------------mm-------m-B-m-----------------------m###-------m----#--#>--m------------------mm-------mm---
----------------mmm------------------mm----mC-m-----K---K------------mO---m----------------K------------------mmmm----mC----m---------------------m####?---------mm--------m----------------mm-m-----mm-m--
----------------mC-m----------------mC-m---mC--m---------------------m-----m--------------------mm-------K---mC-C-m---mc-----mm--------mm--------m#####--------m-m----------m---------------m---mmm--m---m-
--mmmmmmmmmmmmmm-c--mmmmmmmmmmmmmmmmmc--mmmmC---mmmmmmmmmmmmmmmmmmmmm-------mmmmmmmmmmmmmmmmmmmmh-mmmmmmmmmmmmc-c--mmmmc-----C-mmmmmmmm#-mmmmmmmm######---------m--m---------mmmmmmmmmmmmmmm-------mm-----m
##########################################################################################################################---c--#-#-#-#---#-#-#-#######---------#---#-------################--------#----->
