-----------------------------------------------------------------------------------------------------------------------------------------------------------------------------------------------------------
-----------------------------------------------------------------------------------------------------------------------------------------------------------------------------------------------------------
--------------------------------------------------------------------------------------------#-------------------------------------------mmm----------------------------------------------------------------
---------------------------------------------------------------------------------------------------------------------------------------m#B-m---------------------------------------------------------------
----------------------------------------------------------------h------------------------------------mmm------------------------------m##---m--------------------------------------------------------------
----------------------------------------------------------#BBBBBBBBBBBBBB--h-----------B-B-----------m#-mB---------------------------m###----m----------------------mm-------------------------------------
----------------------------------------------------------BBB-----B-BBB--BBBBB----------B-B--------mm----m--------------------------m####-----m--------------------mm-m-----------------------------mm-----
-------------------------------------------------------------------------------------------B-------m#-----mm-----------------mmm---m#####------mm------------------m---mmm-----mm------------------mm-mmm--
--------------------mmm---------------------------------mm-----------------------------mm---B----mm-------k-mmmmmmmmmmmmmmmmmkk-mmm######------#-mmmmmmmmmmmmmmmmmm-------m---mm-m------mm--------mm-----m-
-------------------mm[]mm-------------------------------m#mBBBBBBBBBBBBBBBBB##--------mm-m-------m#------##########################################################--------m--m---m----mm-m-------m-------m
------------------mm-pP--m---???????????M??M??????M---mm-#------------------[]-------mm---m----mm-#-------------------------------------------------------------------------mm-----m--mm---mmmmmmm--K-----K
------------------m--pP---m---------------------------m#-#-mm---------------BBBB??---m-----m--mm#--------------------------------------------------------------------------->>------m-m----##########------
--mmmmmmmmmmmmmmmm---pP----mmmmmmmmmmmmmmmmmmmmmmmmmmm-#-#-k-mmmmmmmmmmmmmmmmmmmmmmmm-------mmm--------------------------------------------------------------------------------------m---------------------
#####################################################################################--------#---------------------------------------------------------------------------------------#---------------------
