-----------------------------------------------------------------------#-----#-#######------------------------------------------------------------------------------>------------------------->------------
------------------------------------------------------------------------#----###########################-------------------------------------------------------------------################----------------
-----------------------------------------------------------------------------------------------------------------------------------------------------------------------------------------------------------
-----------------------------------------------------------------------------------------------------------------------------------------------------------------------------------------------------------
-----------------------------------------------------------------------------------------------------------------------------------------------------------------------------------------------------------
----------------------------------------------------------------------BB----------------------------------#------------------------------------------------------------------------------------------------
------------------------------------------------------------------------B-----------------mm---------------#-----------------------------------------------------------------------------------------------
----------------------------------------------------------------------m--BB-----------mmmmmmm---------------##---------------------------------------------------------------------------------------------
-----------------------------------------------------------mm--------mmm--------B--m-m#??M---mmm-----------------------------------------------------------------------------------------------------------
-----------------------------------------------mm---------mm-mm------m??mm-m--BB--mmm##---------m-------------------mm-----mm-------mm-----mm-----mm-----mm-----mm-----------------------------------------
------------------------mmm------mm---K-------mO-m-------mm----m---Kmm--B-m-m-----mg###----------m--------mm--mm---mm-m---mm-m-----mm-m---mm-m---mm-m---mm-m---mm-m-----mm---------------------------------
------------------------mC-m----mC-m----------mC--m------mC-----m---m----??--m---m#####-----------m-----mmm---m-m--m---m--m---m----m---m--m---m--m---m--m---m--m---m----m-m------------------m----mm-------
--mmmmmmmmmmmmmmmmmmmmmm-c--mmmmmC--mmmmmmmmmmmC---mmmmmm-c------mmm----------mmm######------------mmmmmmm--mm---mm-----mm-----mmmm-----mm-----mm-----mm-----mm-----mmmm---mmmmmmmmmmmmmmmmmm-mmmmk-mmmmmmm
########################################################################-------########-------------##-#-----#----#------#------#-#------#------#------#------#------#-#----#-#-#-#-#-#-#-#-#--#-##########
