-------------------------------------######---c------------------------------------------------------------------------------------------------------------------------------------------------------------
----------------------------------------------#------------------------------------------------------------------------------------------------------------------------------------------------------------
----------------------------------------------------------------------------------------------------------------------------------------------------------mmmmm--------------------------------------------
---------------------------------------------------------------------------------------------------------------------------------------------------------m###--m---------------------------------V---------
-------------------------------------------------------------------------------------------------------------B------------------------------------------m####?--m--------------------------------[]--------
-------------------------------------------------------------------------------------------------------------------------------------------------------m#####----m-------------------------------pP--------
------------------------------------------------------------------------------------------------------------------------------------------------------m######-----m------------------------mmm---pP-------m
------------------------------------m---------m-------------------------------------------------------------mmm--------------------------------------m#######------m----------------------mm[]mm???------mm
---------------------------------mmmmmm---m-mmmmm-----------mmm--+------------------------------------------m#-m------------------------------------m########-------m--------------------mm-pP--m-------mm-
--------------------------------m??M-C-mmmmmmm-C-m---------mm[]mm-----------------------------------------mm----m-----------------mm--------mm-----m#########--------mm-m----------------m--pP---m------m--
--------------------------------m?---c-B?M-C---c--m-------mm-pP--m---------M????M?M???????????????????M--mm#-----mmmmmmmmmmmmmmmmmk-mmmmmmmmk-mmmmm##########--------#-m-mmmmmmmmmmmmmmmm---pP----mmmmmm---
--------------------------------m----c-----c---c---m------m--pP---m--------------------------------------m------###########################################################################################
--mmmmmmmmmmmmmmmmmmmmmmmmmmmmmm-----c-----c---c----mmmmmm---pP----mmmmmmmmmmmmmmmmmmmmmmmmmmmmmmmmmmmmmm--------------------------------------------------------------------------------------------------
######################################-----c---c-----####################################################--------------------------------------------------------------------------------------------------
