-----------------------------------------------------------------------------------------------------------------------------------------------------------------------------------------------------------
-----------------------------------------------------------------------------------------------------------------------------------------------------------------------------------------------------------
-----------------------------------------------------------------------------------------------------------------------------------------------------------------------------------------------------------
-----------------------------------------------------------------------------------------------------------------------------------------------------------------------------------------------------------
-----------------------------------------------------------------------------------------------------------------------------------------------------------------------------------------------------------
--------------------------------------------------------------------------------------------------------------------------------------------------------BBBBBBM?M----BBBBB------------------------------BB-
--------------------------------------------------------------------------------------------------------------------------------------------------------------------------------------------------------mm-
----------------------------------------------------------------------------------------------------------------M--------------------------------------mm--------------------------mmmm-----------------m-m
-------------------------------mmm------------------------------------------------------------------------------K-------------------------------mm-----m-m-----------mm----------mmm[]-m-------------mmm---
------------------------------mm[]m-?---------------------------------------mmm----------------------------------m-----------------------------mm-mmmmm---m--BMBB?--mm-mmm--------m-pP--m-----------mm[]---
-----------------------------mm-pP-m-??????????????-----------------mmmm---m[]-m--------------mm---------------mm-m---------------------------mm-----[]----m-------mm-----m------m--pP---m---------mm-pP---
-----------------------------m--pP-----------------------------mm---m[]-m--mpP--m-----mm-----m#-m---mm---------m#--m--------------------------m------pP-----m------m-------m-----m--pP----m--------m--pP---
--mmmmmmmmmmmmmmmmmmmmmmmmmmm---pP--mmmmmmmmmmmmmmmmmmmmmmmmmmmh-mmm-pP--mmmpP---mmmmmg-mmmmmm#--mmmk-mmmmmmmmm-#---mmmmmmmmmmmmmmmmmmmmmmmmmm-------pP-k----mmmmmm---------mmmmm---pP-----mmmmmmmm---pP---
###################################################################################################################################################################----------###########################---
