---------------------------------------------#------------------------------------------------############---pP--------------------------pP------?---[]----------------------------------------------------
-------------------------------------------------------------------------------------------------------------pP----------------------######-------#--pP----------------------------------------------------
-------------------------------------------------------------------------------------------------------------pP------------------------------------######--------------------------------------------------
-----------------------------------------------##------------------------------------------------------------pP--------------------------------#-----------------------------------------------------------
-------------------------------------------------------------------------------------------------------------pP---------------------------------#----------------------------------------------------------
-------------------------------------------------------------------------------------------------------------pP--------------------------------------------------------------------------------------------
-------------------------------------------V-----------------------------------?---------------------------BBB----mm---------------------------------------------------------------------------------------
-------------------------------------------[]--------------------------------------------------------------mm----mm-mmm--------------------------# --------------------------------------mmm---------------
--------------------------------------mmm--pP--V---BBB-------mm-------------mmmm--------mmmmmm-------------m-m--mm-----m---------??M-------------pP-------------------------------------mm[]mm-------------
-------------------------------------mm[]mm???-[]----BBB----mm-mmm---------mm[]-m------mm[]---m----------mm-----m-------m-------?M---------------pPm---------------mm-------------------m-pP--m------------
------------------------------------mm-pP--m??MpP--mm------mm-----m------m-m-pP--m----mm-pP----mmm------m[]---mm---------m---------mm----mmmmm---[]-m------mm-----mm-m------mmmm-----mmm--pP---m---mmmm----
------------------------------------m--pP------?--mm-m-----m-------m----m-m--pP---m---m--pP----[]-m----m#pP---[]-------#--m-----mmmC-m--mm[]--m--V---m----mm-m----m---m-----m[]-m----m[]--pP----m--m[]-m---
--mmmmmmmmmmmmmmmmmmmmmmmmmmmmmmmmmm---pP---mmmmmmm---mmmmm---------mmmmk-k--pP----mmm---pP----pP--mmmm##pP---pP-------#---mmmmm###C--mmm-pP---mmm----mmmmm---mmmm-----mmmmm-pP--mmmm-pP--# -----mm-pP--mmm
##############################################k--#-----#-###---------##########--##########----pP---#-###pP---pP-------#############---#--pP----#?#---V#-#-----#-#------######################---##########
