-------------------------------------------------------#########################################################-------------------------------##?###################################[]--------------------
-----------------------------------------------------------------------------------------------------------------------------------------------######################################pP--------------------
------------------------------------------------------------------------------------------------------------------------------------------m---#######################################pP-----------------#--
--------------------------------------------------------------------------------------------------------------------mm-------------------m----#######################################pP--------------------
----------------------------------------------------------------------------------------m--------------------------mm-mmm----------------mgmm-#######################################pP----#---------------
-------------------------------------------------------mm-----------------------------mm-m------------------------mm----Vmm--------------mC#--#######################################pP--------------------
------------------------------------------------mm----mm-m---------------------------m##--m-----------------------m-----[]-m------------m###-m#######################################pP----##-##-----------
-----------------------------------------------mm-mm--m---m-----------mm------------m###---m------------------mmmm------pP--m----------m####----#####################################pP----#-#-------------
----------------------------------------------mm----mm-----m---------m#-m----------m####----m----------------m####------##---m--------m#####--m-#####################################pP######--------------
------------------------BB-----mm------------mm-----[]------m-------m##--m--------m#####-----m--------------m##---------------mmmmmmmm######---m-####################################pP----------mm--------
------------------mmm---------mC-m----mm----mC------pP-------m-----m###---m------m######------m------------m###--------------###################m######################################----------m-m------m
------------------mC-m----mm--mC--m--mC-m---mc------pP-------Vmm--m####----m----m#######-------m-------m--m####---------------------------------#-----------------------------------------m---m-----m--m--m
--mmmmmmmmmmmmmmmm-c--mmmmh-mmmpP--mmmC--mmmmpP-----pP-------[]-mm#####-----mmmm########--------mmmmmmm-mm#####----------------------------------mmmmmmmmmmmmmmmmmmmmmmmmmmmmmmmmmmmmmmmmm-mmm-mm----mm-mm-
######################################################-------pP--######------#-#########--------#-#-#-#--######----------------------------------#####################################V#-#-#-#--#-----#--#-
