-------------------------------------------------------------pP--#####-------------------------------------------------------------------------------------------------------------------?##---------######
------------------------------------------------------------##########--------------------------V---------------------------------------------------------------------------------------m###---------######
------------------------------------------------------------------------------------------------[]-------------------------------------------------------------------------------------m####---------######
------------------------------------------------------------------------------------------------pP-----------------mm---------------------mm------------------------------------------m#####---------######
------------------------------------------------------------------------------mmm---------mm---?pP--------------mmmmVm-------------------m#-mm----------------------mmmm-------------m######---------#####p
-------------------------------------BB???MB--B------------------------------mm[]mm------mm-mmm-??????M?----mmmm[]#-[]mm----------------m##-B-mo-------------------m#BB-m-----------m#######---------#####p
--------------------------------------------BB-B----------------------------mm-pP--m----mm--[]-m---------mmm[][]pP--pP--m---------K----m###----m------------------m##----mm--------m########---------#####p
---------------------------------------------BBBBB--------------------------m--pP---m---m---pP--m--------m[]pPpPpP--pP---m------------m####-----mmm--------------m###----B-m------m#########---------######
--------------------------------mmm----------mm---B----mm-------------mmmmmm---pP----mmm----pP---mmmmmmmm-pPpPpPpP--pP----mmmmmmmmmmmm#####-----[]-m------------m####-------mmmmmm##########---mm----------
-------------------------------mm[]m-?M???BBmm-m------mm-mmm---------m#####################################################################-----pP--m----------m#####-------##############----mm-mmm-------
------------------------------mm-pP-m------mm---m----mm--[]-m-------m##-------------------------------------------------------------------------B#---mmmmmmmmmm######------------------------mm-----m------
------------------------------m--pP--m-----m-----m---m---pP--m-----m###-----------------------------------------------------------------------------#################------------------------m-------m-----
--mmmmmmmmmmmmmmmmmmmmmmmmmmmm---pP---mmmmm-------mmm----pP---mmmmm####-------------------------------------------------------------------------------------------------------------------mmm---------mmmmm
############################################-------########---[]-######-------------------------------------------------------------------------------------------------------------------###----------####
