--------------------------------#-##########---------------------------------------------------------?--------------?######################################################################################
---------------------------------###########--------------------------------------------------------mm-------------m#######################################################################################
----------------------------------------####-------------------------------------------------------mm-m-----------m########################################################################################
--------------------------------mm-------#########################---------------------------------m---m----------m########################################################################################
----------------------mm-------mm-m--------------------------------------------------------------mm-----mm-------m#########################################################################################
---------------------mm-m-----mm---mmm--------------------------------------------BBBBBBMMB------m#-----#-mmmmmmm##########################################################################################
--------------mm----mm---m---mm-------m--------------------------------------------------------mm-#----##-#################################################################################################
-------------mm-mm--m-----m--m---------------m-------------mm----------------------------------m#----------------------####################################################################################
------------mm----mm-------mm----------mmmmmm-m-----------mm-m------------------mm-----------mm-------------------------###################################################################################
------------m-----[]-------[]----------######--m-----mm---m---m----------------mm#mmBBBBMBBBmm##-------------------------##################################################################################
----------mm------pP-------pP---BB-----######---m---mm-mmm-----m----mm--------mm-#--m-------m-------------------------mmm-#################################################################################
----------mC------pP-------pP---B-----#######----m--m----M------m--mm-m-------m--#---m-----m-------------------------mg##m---------------------------------------------------------------------------------
--mmmmmmmm-c------pP---t---pP---g---#########-----mm-------------mmm---mmmmmmm---#----mmmmmm-------------------------m####mmmmmmmmmmmmmmmmmmmmmmmmmmmmmmmmmmmmmmmmmmmmmmmmmmmmmmmmmmmmmmmmmmmmmmmmmmmmmmmmm
#############################################------#--------------#-----#####################----------B-------------######################################################################################
