------------------------------------------------------------------------------------------------------?-------------------------------------------------------------------?####----------------###---------
-----------------------------------------------------------------------------------------------------mm------------------------------------------------------------------m#####----------------###---------
--------------------------------------------------------------------------------------------------mmmm-m-----------mm-----------mmm---------------------mm--------------m######----------------###---------
-------------------------------------------------------------------------------------------------m#BM---m---------mm-mmm-------mm[]mm--??????????--M---mm-mmm----mm----m#######----------------###---------
------------------------------------------------------------------------------------------------m##--B---m-------mm-----m-----mm-pP--m-----?---?-??---mm-----m--mm-m--m########----------------###---------
-----------------------------------------------------------------------------------------------m###-------m------m-------mm---m--pP---m---------------m-------m-m---mm#########----------------###---------
-----------------------------------------------------------------------------mm---------------m####--------mmmmmm--------#-mmm---pP----mmmmmmmmmmmmmmm---------m----##############################-########
-----------------------------------------------------------------------------m-m-------------m#####------###########-------##############################------#----#######--------------------####-------#
--------------------------------------------mmm--+---------------------mmm--m---m----mm-----m######--------------------------------------------------------------------------------------------------------
--------?M?M-------------------------------mm[]mm---------------------mm#+mmB----mmmmg-mmmmm#######----------------------------------------------------------------------------------mm------------m-----mm
------------------------------------------mm-pP--m-----?????????M----mm-#--B-----#####################--------------------------------------------------------------------------m---mm-m---mm-------m---mm-
-----------------mm--------mm-------------m--pP---m------------------m--#----------------------------------------------------------------------------------------------------mmm-m--m---m--m-m--mmm--m--m--
--mmmmmmmmmmmmmmmg-mmmmmmmmg-mmmmmmmmmmmmm---pP----mmmmmmmmmmmmmmmmmm---#--------------------------------------------------------------------------------------------------mm###--mm-----mm---mm###---mm---
##########################################################################------------------------------B-------------------------------------------------BBBBB------------#####---#------#----####----#---
