------------------------------------------------------------------------------------------------------------------------c--##------------------------------------------------------------------------------
---------------------------------------------------------------------------------------------------------#------------B-#--##------------------------------------------------------------------------------
---------------------------------------------------------------------------------------------------------#################-##------------------------------------------------------------------------------
--------------------------------------------------------------------------------------------------------------------------####--#--------------------------------------------------------------------------
-----------------------------------------------------------------------------------------------------------------------------------------------------------------------------------------------------------
-----------------------------------------------------------------------------------------------------------------------------------------------------------------------------------------------------------
---------------------------------------B-------------------------------------------------------------------------------------------------------------------------------------------------------------------
--------------------------------------------------------------------------------------m-------------------------------------------------------------------m------------------------------------------------
-------------------------------------------------------mm-----------------------------mmmmm-------mm----------------------------------------------------mm-m-----------------------------------------------
-----------------------mm---????????---mm-------------mm-mmm-------------------------m-??M-m-----mm-mmm--------------mm--------B------------------------mB--m-------------------------------------BBBBB----
---------------mmm----mC-m-K----------m#-m-----mmm---mm-----m---mmm--Kmmm-----------m#------m---mm-----m-----mm-----mm-m------------#-----mmmm-------mmm-----mmm---mmm------------mmm---------mmm----------
---------------mC-m---mc--m---mm------m#--m----mC-m--mC------m--mC-m--mC-m-K----mm--m#-------m--mC------m----m-m----m---m-mmm-------------m[]-m------m[]-----[]-m--mC-m------------#-m---------#-m---------
--mmmmmmmmmmmmm-c--mmmmC---mmmh-mmmmmmm#---mmmm-c--mm-c-------mm-c--mm-C--mmmmmmh-mmm#--------mm-c-------mmmm---mmmm-----mmm-mmmmmmmmmmmmm-pP--mmmmmm-pP-----pP--mm-c--mmmmmmmmmmmmC--mmmmmmmmm#--mmmmmmmmm
######################################################################################################----#-#----#-#-----C--##BB-#-#-######################################################################
