-----------------------------------------------------------------------------------------------------------------------------------------------------------------------------------------------------------
-----------------------------------------------------------------------------------------------------------------------------------------------------------------------------------------------------------
-----------------------------------------------------------------------------------------------------------------------------------------------------------------------------------------------------------
-----------------------------------------------------------------------------------------------------------------------------------------------------------------------------------m-----------------------
---------------------------------------------------------------------------------------------------------------------------------------------------------------------------------mm-m----------------------
----------------------------------------------------------???M-----------BMM?BBBB--BBBBBBBBBBBB----------------mmmm------------?BBBMM?????-------------------------M???M--------m##--m---------------------
----------------------------------------------------------------------------------B---------------------------mm##-m-----------------------------------------------------------m###---m--------------------
--------------------------------------------------------------------------------------------------------------m-##--m---------------------------------mmm-mm------------------m####----m-------------------
-------------------------------------mm----------mmm----------------------k-------mm-----------------------mmm--##---m--------------------------------m??mmVmm---------------m#####-----m------------------
-------------?M?--------------------mm-mmm------mm[]mm--???M?-B--mmm-----BBBBBB#-mm-mmm--BBBBMB-----------m###--##----m----------------?--------------m--?-[]-m---BBBMB-----m######------m-----------------
---------mmm-------K----mmm--------mm-----mm---mm-pP--m---?-----mm#-m-----------mm-----m---------mmmmmmmmm####--##-----m------------------------------m----pP--m-----------m#######-------m--------mmm-----
---------mC-m-----------mC-m-------mC-----C-m--m--pP---m--------m-#--m----------m-------m-------m#############--##------m----------------------K------m----pP---m---------m########--------mm-m----m#-m----
--mmmmmmm-c--mmmmmmmmmmm-c--mmmmmmm-c-----c--mm---pP----mmmmmmmm--#---mmmmmmmmmm-------#-mmmmmmmm#############--##-------mmmmmmmmmmmmmmmmmmmmmmmmmmmmm-----pP----mmmmmmmmm#########--------#-m-mmmm-#--mmmm
################################################################--##############-------#######################--###########################################################################################
