----------------------#############################################-----#######################################--------------------------------------------------------------------------------------------
-------------------------------------------------------------------------------------------------------------------------------------m---------------------------------------------------------------------
----------------------------------------------------------------------------------------------------------------m------------------mm-m--------------------------------------------------------------------
------------------------------------------------------------------------------------mm-------------------------m-m----------------m##--m---------------------------------------------------mm--------------
-----------------------------------------------------------------------------------mm-mmm--------------------mm?--m--------------m###---m-------------------------------------------------mm-mmm---mm------
----------------------------------------------------------------------B-----------mm-----m------------------mmg----m------------m####----m------------------------------------mmm--------mm-----mmmk-mmmmmm
----------------------------------------mm-----------------------------B----------m-------m----------------m###-----m----------m#####-----m----------mmm--o------------------m#B-m-------m------###########
--------------------------------------mm#-m-----------------------[]-------------m------------------------m####------m--------m######------m--------mm[]mm---?????????------m##---m-----m------------------
---------------------------------------##--m----------------------pP------------m#---------mmmmmm--------m#####-------m------m#######-------m------mm-pP--m----------------m###----mmmmm#------------------
---------------------mmm--------------m##---m----------------mmm--pP-----------m##---------#####-m---?--m#######-------m----m########--------mm-m--m--pP---m--------------m####----######------------------
-------------mmm---K-mmmm------------m###----m--------------mm[]mm??--mm------m###------########--m----m#######---------mmmm#########--------#-m-mm---pP----mmmmmmmmmmmmmm#####----------------------------
-------------mC-m---mC-Y-------mm---m####-----m---------m--mm-pP--m---m-m----m####----##########---m--m########V-------########################################################----------------------------
--mmmmmmmmmmm-c--mmmmC-y-mmmmmm#-mmm#####------mmmmmmmmm-mm#--pP---mmm---mmmm#####---###########----mm#########[]------------------------------------------------------------------------------------------
########################--#-#-#--#-######------#-#-#-#-#--#---pP---###----#-######---###########-----##########pP------------------------------------------------------------------------------------------
