---------------------------------------########################---pP----------------------------------------------#######----------------------------------------------------------------------------------
-----------------------------------------------------------------------------------------------------------------------------------------------------------------------------------------------------------
-----------------------------------------------------------------------------------------------------------------------------------------------------------------------------------------------------------
-----------------------------------------------------------------------------------------------------------------------------------------------------m-----------------------------------------------------
---------------------------------------------------------------------------------------------------------------------------------------------------mm-m-----------m----------------------------------------
-----------------mmmmm----------------------------m-m----------------------------BBBBB?BBB--------------------------------------------------------m##--m----------mmB--------------------------------------
----------------m#??M-m--------------------------mgm-m---------------------------------------------------------BB------------------------------mmm###---m-------mm-?mmm------------------------------------
---------------m##-----m-------------------------mg#--m----------------------------------------------------------B----------------------------m######----m------m#--##-#-----------------------------------
--------------m###------m----------mm-----------m###---m-----------------------mm-------------mm-------------------------mmmm----------------m#######--#--mmmmmm-#-----m------------------mm---------------
-------------m####-------m--------mmVmm--------m####----m------mm-------------mm#mm?BBBBBBB--mm-mmm-----------mm--------m#B--mm----mm-------m########--############-----mmmmmmmmmmmmmmmmmmk-mmmmmmmmmmmmmmm
------------m#####--------m------mm-[]-m------m#####-----m----mm-m-----------mm-#--m--------mm-----m---------mm-m------m##---#-mmmmk-mmmmmmm######----------------------###################################
-----------m######---------mm-m--m--pP--m----m######------m---m---m----------m--#---m-------m-------m--------m---m----m###-----##################----------------------------------------------------------
--mmmmmmmmm#######---------#-m-mm---pP---mmmm#######-------mmm-----mmmmmmmmmm---#----mmmmmmm---------mmmmmmmm-----mmmm####---------------------------------------------------------------------------------
######################################----#-########-------#-#-----[]-######################-------##########------#-#####---------------------------------------------------------------------------------
