---------------------------#---------------pP-#pP-------------#-#----------#########################################---------------------------------------------------------------------------------------
----------------------------#--------------pP--########################------------------------------------------------------------------------------------------------------------------------------------
-------------------------------------------pP--------------------------------------------------------------------------------------------------------------------------------------------------------------
-----------------------------#-------------pP--------------------------------------------------------------------------------------------------------------------------------------------------------------
------------------------------#-------Y----###----------------------------------------------m--------------------------------------------------------------------------------------------------------------
-------------------------------##-----y-------#-------------------------------------------mm-m------------------------------------------------------------------------BB*BBBBBB----------------------------
--------------------------------##########-----#-----------------------------------------m##--m-------------------------------------------------------------------------------------------mm---------------
----------------------------------------------------------------------------------------m###---m---------------------m-------------------------------------------------------------------mB-m--------------
-------------------mmmmmmmmmmm------------------#--------------------------------------m####----m-------------------m-m-------------mmm---+--------------------------B------------------m#---m------------m
------------------m##########mm-----------------------------------------mm------------m#####-----m-----------------m#--m-----------mm[]mm????????????????-------------BBBBBBBBB--------m##----mmm--------m#
-----------------m#########----------mm---mm---------------------------mm-mmmmm------m######------m---------------m##---m---------mm-pP--m-----------------------mmmm-----------------m###----[]-m------m##
----------------m##########--?-m-om--m-m--m-m--m--------m----m--m-m----m----[]-m----m#######-------m---m----m--mmm###----m--------m--pP---m----------------------m[]-m---------------m####----pP--m----m###
--mmmmmmmmmmmmmm###########-----mm-mm---mm--Vmmmmmmmmmmm-mmmm-mm-m-mmmm-----pP--mmmm########--------mmm-mmmm-mm######-----mmmmmmmm---pP----mmmmmmmmmmmmmmmmmmmmmm-pP--mmmmmmmmmmmmmmm#####----pP---mmmm####
############################-----#--#----#--[]#-[]-#-#-#--#-#--#-#--#-#-----pP---#-#########--------#-#--#-#--#######-----#################################################################################
