-----------------------------------#--C----------?-----------------Y---------------------------------------------------------------------------------------------------------##############################
------------------------------------#-c--------------------#-------y---------------------------------------------------------------------------------------------------------------------------------------
-------------------------------------#c----------c---------#########---------------------------------------------------------------------------------------------------------------------------------------
--------------------------------------#----------c-----------------##--------------------------------------------------------------------------------------------------------------------------------------
-----------------------------------------#-------c---------------------------------------------------------------BBBM???--------B-------------------------------------------------m------------------------
------------------------------------------#####--c-######------------------------------mm-----------------------------------------------------mm-----------------------------mmmmm-m-----------------------
--------------------------------mm-------------####-----------------------------------m#-mo--------------------------------------------------m#-m--------------mm-----------mm####--m----------------------
-------------------------------mm-mm-------------------------------------------------m##--m---------------mm-----------------mmm------------m##--m------------mm-mmm--------m-####---m---------------------
------------------------------mm----m-----------------------------------------------m###---m-------------mmVmm---BBBBBM?-----m?-mm---------m###---m----------mm-----m---mmmm--####----m--------------------
------------------------------m------m-B------------mm------B---mm-----------------m####----m-----------mm-[]-m------------mm---#---------m####----m---------m-------m-m####--####-----m-------------------
----------------------------mm------C------mm------mm-m--------mm-m---------------m#####-----mm---------m--pP--m-----------m#---#-m------m#####-----mm-m----m-------#-m#####--####------m-----------------m
----------------------------mC------c-m-m--m-m--m--m---m--m----m---m------m-m----m######-----#-mmmmmmmmm---pP---mmmmmmmmmmm-#---#--mmmmmm######-----#-m-mmmm#-------########--####-------m-------m----m--m#
--mmmmmmmmmmmmmmmmmmmmmmmmmm-c------c--m-mm---mm-mm-----mm-mmmm-----mmmmmm-m-mmmm#######-----################################################################-------########--####--------mmmmmmm-mmmm-mm##
####################################c--#--#----#--#------#--#-#------#-#-#-#-###########----------------------------------------------------------------------------########--####--------#-#-#-#--#-#--###
