--------------------------------------------------------------o-oh-----------------------------------------------------------------------------------------------------------------------------------------
------------------------------------------------------------MBBBBBB-----------------------------------------------------------------------------------------------mmmmm------------------------------------
--------------------------------------------------------------------------*----------------------------------------M---------------------------------------------mm####------------------------------------
---------------------o-------------------------------------------------------------------------------------------------------------------------------------------m-####------------------------------------
-------------------mmm-----------mmm-------------------------------------m-------------------------------------------------------------------------------mmmmmmmm--####------------------------------------
------------------mmm-m---------mm[]mm--??????????--------------BBB-------mm----??M?----?--------------------------mm-----------------------------------m########--####------------------------------------
----------------mm#----m-------mm-pP--m---??-----------------------------m#-m-------------------------------------m#-m----mmmmm-----------------------mm#########--####-----###----------------------------
---------------m##------m------m--pP---m---------------------------------m#--m--------------mm----------mm--------m#--m---m[]#-m---------------------m###########--####---m--------------------------------
--------------m##--------mmmmmm---pP----mmmmmmmmmmmmmmmmmmmmmmmmmmmmmmmmm-#---mmmmmmmmmmmmmmk-mmmmmmmmmmk-mmmmmmmmm#---mmm-pP#--mmmmmmmmmmmmmmmmmmmmmm--#########--####----m-------------------------------
-------------m###--------#[]#####################################################################################################################################--####-##--m----------------------mm------
------------m####--------------------------------------------------------------------------------------------------------------------------------------------------#####--------------------------mm-m-----
-----------m#####------------------------------------------------------------------------------------------------------------------------------------------------------------m--------------------m---m----
--mmmmmmmmm######-------------------------------------------------------------------------------------------------------------------------------------------------------------mmmmmmmmmmmmmmmmmmmm-----mmmm
##################------------------------------------------------------------------------------------------------------------------------------------------------------#-----####################----#####
