-------------------------------------------------------##--------------------------------------------------------------------------------------------------------------------------------------------------
--------------------------------------------------------########-------------------------------------------------------------------------------------------------------------------------------------------
---------------------------------------------------------------###---------------------------mm--m---------------------------------------------------------------------------------------------------------
--------------------------------------------------------------------------------------------mm-mm-m--------------------------------------------------------------------------------------------------------
-------------------------------------------------------------------------------------------mm---------m----------------------------------------------------------------------------------------------------
--------------------------------------------------BB---------------------------------------m-------mmm-m---------------------------------------------------BBBB??????---------------m-mm-------------------
-------------------------------------------------B----------------------------------------m--------###--m--------------------------------------------------------------------------m--m-m------------------
----------------------------------------------------mm-----------------------------------m#-------####---m-------------------------------------------------------------------------mgm---m-----------------
-------------------------------------------------mmmmmm---------------------------------m##-------####----m----------------------------------------mm--------h--------------B------m##----m----------------
-----------------------------mm----------mm-----mmBB---m-------------------------------m###------#####-----m--------------------------------------mm-mmm---BBBBBBM??---------BB---m###-----m---------------
-------------------mmm------mC-m--------mC-m---mm-------m-----------------------------m####------#####------m------------------------------------mm--[]-m----------------mmm-----m####------mmm---------K-m
-------------------mC-m-----mc--m-----K-mc--m--m----B----m-----------m--m-mm---------m#####-----######-------mm-m--------------------------------m---pP--m--------------m[]-m---m#####------[]-m---------m#
--mmmmmmmmmmmmmmmmm-c--mmmmmmc---mmmmmmmmc---mm-----------mmmmmmmmmmm-mm-mk-mmmmmmmmm######---########-------#-m-mmmmmmmmmmmmmmmmmmmmmmmmmmmmmmmm----pP---mmmmmmmmmmmmmmmpP--mmmm#####------pP--mmmmmmmmm##
###############################################------------#-##-#-#-#--#-##################################################################################################################################
