-----------------------------------------------------------------------------------------------------------------------------------------------------------------------------------------------------------
-----------------------------------------------------------------------------------------------------------------------------------------------------------------------------------------------------------
-----------------------------------------------------------------------------------------------------------------------------------------------------------------------------------------------------------
-----------------------------------------------------------------------------------------------------------------------------------------------------------------------------------------------------------
-----------------------------------------------------------------------------------------------------------------------------------------------------------------------------------------------------------
-------------------------------------------------------------------------------------------------------------------------------*----BBBBB-------------------------------?????----------V----BB-?BBBB-------
-----------------------------------------------------------------------------------------------------------------M-----------------B---------------------------------------------------[]------------------
-------------------------------------------------------------------------------------------------------------------------------mm------------------mmm---------------------------------pP------------------
---------------------------------------------------------------------------------------mm-------------------------------------mm-m-------h----------#-m----------mmm--------------mmm--pP-----mmmmmmm------
-------------------------mm--??????----mm-------------mm----------------mm------------mm-mmmm--????--------------mm-----------m?--m---BBBBBB-------m#--m--------mm[]mmB???????---mm[]mm----mmm???BBB-m-----
-----------------mmm----mC-m----------mC-m-----------mC-m-----Kmm------mC-m----------mm----C-m------------------m#-m--------mm-----m--------------m##---m------mm-pP--m---------mm-pP--m---m[]--------m----
-----------------mC-m---mc--m---------mc--m----------mc--m-K--mC-m-----mc--m---------mC----c--m--------mm-------m#--m-------m#------m------------m###----mm----m--pP---m--------m--pP------mpP---------m-K-
--mmmmmmmmmmmmmmm-c--mmmmc---mmmmmmmmmmC---mmmmmmmmmmmC---mmmmmc--mmmmmmc---mmmmmmmmm-c----c---mmmmmmmmh-mmmmmmmm#---mmmmmmm-#-----#-mmmmmmmmmmmm####----#-mmmm---pP----mmmmmmmm---pP---mmm-pP----------mmm
###########################################################################################################################################################################################################
