-----------------------------------------------------------------------------------------------------------------------------------------------------------------------------------------------------------
-----------------------------------------------------------------------------------------------------------------------------------------------------------------------------------------------------------
-------------------------BBB--------------------------------------------------------------------V---------------mm------------------------------------------------------------------------BBB-----ooo------
---------------------------------------------V--------------------------mmm---------------------[]-------------mm-mmm------------------------------------------------------------------------B--BBBBBBBBB--
---------------------------------------------[]------------------------m#B-m--------------mmm---pP------------mm----Vmm------------------------------------------------------------------------------------
----------------------BBB--------------mmm--?pP-----------------------m##---m--m-#-------mm[]mm-?????????-----m-----[]-m-----??------------------------?-??---------------------------B--mm----------------
------------------mm-----?------------mm[]mm-?????????????-----------m###----mm-m-------mm-pP--m-----------mmm------pP--m---------------------------------------------------------------mm-m---------------
-----------------m#-m----------------mm-pP--m-----------------------m####----BB--m------m--pP---m----------m[]------pP---m-------------------------------mm-----------------------------m---m--BBBBBBBBB---
----------------m##--mmmm--------K---m--pP---mmmm-----------mm-----m#####---------mmmmmm---pP----mmmmmmmmmm-pP------pP----mmmmmmmmmmmmmmmmmmmmmmmmmmmmmmmC-mmmmmmmmmmmmmmmmmmmmmmmmmmmmm-----m-------------
-----BM?-------m###--BB##mmmmmmmmmmmm---pP----kk-mmmmmmmmmmmk-mmmmm######---------######################################################################################################------m------------
--------------m####------################################################----------------------------------------------------------------------------------------------------------------------mmmmmmmmmmmm
-------------m#####----------------------------------------------------------------------------------------------------------------------------------------------------------------------------############
--mmmmmmmmmmm######----------------------------------------------------------------------------------------------------------------------------------------------------------------------------------------
#########################----------------------------------------------------------------------------------------------------------------------------------------------------------------------------------
