-----------------------------------------------------------------------------------------------------------------------------------------------------------------------------------------------------------
-----------------------------------------------------------------------------------------------------------------------------------------------------------------------------------------------------------
-----------------------------------------------------------------------------------------------------------------------------------------------------------------------#-----------------------------------
-----------------------------------------------------------------------------------------------------------------------------------------------------------------------------------------------------------
-----------------------------------------------------------------------------------------------------------------------------------------------------------------------------------------Y-----------------
-----------------------------------------------------------------------------------------------------------------------------------------------------------------------------------------y-----------------
--------------------------------------------------------------------------------------------------------------mm--------------------------------------------------mm-------##############------------------
-------------------------------------------------------------------------------------------B-----------------m#-m------------------------------------------------m#-m--------------------------------------
----------------------------------------------------------------------------------------------mm------------m##---------------mm---------------------mm---------m###---------------------------------------
------------------------------------mm---BB-----------mm--------------------mm----?????#----mmm-m----------m###--m#O?M????---mm#mmm-----------------mm-m-------m###--m----mm----------------------mm-------
------------------mmm--------------mC-m----mmm-----K-mC-m-----------mm-----mC-m-------K---m-mm---m--------m####------?------mm-#---m---mm-------h---m---m-----m####------mm-m---mm------mm-------mm-m-----m
------------------mC-m-------------mc--m---mC-m--K---mC--m----mm---mC-m----mc--m-----------m------m------m#####---m--------mm--#----mmmk-mmmmmmmmmmm-----mm--m#####---m--m---m--m-m--m--m-mm--m--m---m----m
--mmmmmmmmmmmmmmmm-c--mmmmmmmmmmmmmmC---mmm-c--mmmmmmmc---mmmmh-mmmmc--mmmmmc---mmmmmmmmmmm#-------mmmmmm######----mmmmmmmmh---#----################-----#-mm######----mm-----mm---mm-mm----mm-mm-----mmmm-
############################################################################################--------#-###########################--------------------------##########---#------#----#--#-----#--#------#-#-
