------------------------------------------------pP--------------------------------------------------------------####################--------#-------------#######---------#-########--------#---#-######---
-------------------------------------##----##-########---------------------------------------------------------------------################################################################################
--------------------------------------------------------------------------------------------------------------------------mm-------------------------------------------------------------------------------
-------------------------------------------------------------------------------------------------------------------------mm-mm-----------------------------------------------------------------------------
------------------------------------------------------------------------------------------------------------------------mm----m----------------------------------------------------------------------------
-------------------mm--------------------------------------------------------------------BBBMM--------BB----------------m------m-----m----------------------------mm-----------------m---------------------
------------------m#-m----------------------------------------------------------------------------------BB-------------m--------m--mm-m--------------------------m--m--------------mm-m-------------------m
-----------------m##--m-----------------------------------------------------------------------------------B-----------m#----------m##--m------------------------m#---m------------m##--m-----------------mm
----------------m###---m-----------m------------mm-------------------------------------Boo-----------mmm---BB--------m##---------m###---m----------------------m##?---m----------m###---m---------------mm-
---------------m####----m----------mm----------mm-m-------------------------------------BBBBBB-------m#-m-----mm----m###---------####----m--------------------m###-----m--------m####----m-----------------
--------------m#####-----m-------mm--m--------mm-V-m---------------------m------K---mmm-----------mmm----m---mm-m--m####-----#--#####-----m------------------m####------m------m#####-----m-------------m--
-------------m######------m-------#---m---m---m?-[]-m----m-----mm-------m-mm-------m[]-m----------m[]-----m--m---mm#####----#########------m----------------m#####-------m----m######------m----m------m#--
--mmmmmmmmmmm#######-------mmmmmmm#----mmm-mmm---pP--mmmm-mmmmmk-mmmmmmmk-k-mmmmmmmmpP--mmmmmmmmmm-pP------mm-----######----#########-------mmmmmmmmmmmmmmmm######--------mmmm#######-------mmmm-mmmmmm##--
####################################----##--##---pP---#-#-#############################################-----#----#######---##########--------#-#-#-#-#-#-#########---------#-########--------#-#--#######--
