-----------------------------------------------------------------------------------------------------------------------------------------------------------------------------------------------------------
-----------------------------------------------------------------------------------------------------------------------------------------------------------------------------------------------------------
-----------------------------------------------------------------------------------------------------------------------------------------------------------------------------------------------------------
-----------------------------------------------------------------------------------------------------------------------------------------------------------------------------------------------------------
-----------------------------------------------------------------------------------------------------------------------------------------------------------------------------------------------------------
-------------------------------------------------------------------------------------------------------------------------------------BBBBB------------------------mm---------------------------------------
---------------------------------------------------------M---------------------------------------------------M---------------------------------------------------mm-m--------------------------------------
-----------------------------------------------------------------------------------------------------------------------------------------------------------mm----m---m-------------------------------------
----------------------------------------------------h----------------------------------------------------------------mm-------------mmmmmm----------------mm-mmmm-----m--o---------------------------------
------BBBBBB--------------------------------mm----BBBBB--mm--------------------------------------------------mm-----mm#mm-----------m??BB-m---------------m----[]-----Vmm--------------?----?M-------------
-------------------------mmm----mmm--------m?-m---------m#-m--------------------------mm-----------mm-------m#-m---mm-#--m---------m?------m-------------m-----pP-----[]-m---------------------------------
--------------------mm---m#-mm---#-mm------m---m--------m#--m----mm----mm------------mC-m---------m#-m------m#--m--m--#---m-----hh-m--------m------------m-----pP-----pP--m------mmmm----------------------
--mmmmmmmmmmmmmmmmmmh-mmm-#-B-mmm#-k-mmmmmmm----mmmmmmmmm#---mmmmh-mmmmh-mmmmmmmmmmmmmc--mmmmmmmmmm#--mmmmmmm#---mm---#----mmmmmmmmm---------mmmmmmmmmmmmm-----pP-----pP---mmmmmmggg-mmmmmmmmmmmmmmmmmmmmmm
###########################################################################################################################################################################################################
