------------------------------------------------------------------------------------------------------------------------------------------------#########################---###############################
----------------------------------------------------------------------------------------------------------------------------------------------##-----------------------------------------------------------
-----------------------------------------------------------------------------------------------------------------------------------------------------------------------------------------------------------
-----------------------------------------------------------------------------------------------------------------------------------------------------------------------------------------------------------
------------------------------------------------------------------------------------------------------------------------------------------------------------------------------------------------m----------
-------------------------------------------BBBM----------------------------------------------------V---BBBB---------B---------------------BBB-------------------------------------------------mm-m---------
--------------------------M-----------------------------------M------------------------------------[]-------------------------------------B-BB-----------------------------------------------m##--m--------
---------------------------------------------------------------------------------------------------pP-----------------------------------------BBB-----mmm-----------------------------------m###---m-------
--------------------------------------mm----h-h----mm-------------------------mm-----o--------mmm--pP-----------mmmmmm--------------------mm---------m#B-m---------------------------------m####----m------
--------------------------mm---------mm#mmBB?BBB--mmhmm-------mm-------------mm-mmmmm--------mm[]mm???--BBB-----m##BB-m------------------mm-m-------m##---m------------mmm-mm-------------m#####-----m-----
-------------------mmm---m#-m-------mm-#--m------mm-#--m--K--m#-m-----------mm----[]-m------mm-pP--m---------mmm-##----m----------------mm---m-----m###----m----------mm[]m--m-----------m######------m----
-------------------mC-m--m#--m------m--#---m-----m--#---m----m#--m----------mC----pP--m-----m--pP------------m[]-##-----mm--------------m-----m---m####-----m---m----mm-pP----m----m----m#######-------m---
--mmmmmmmmmmmmmmmmm-c--mmm#---mmmmmm---#----mmmmm---#----mmmmm#---mmmmmmmmmm-c----pP---mmmmm---pP---mmmmmmmmm-pP-##-----#-mmmmmmmmmmmmmm-------mmm#####------mmm-mmmm#--pP-----mmmm-mmmm########--------mmm
#################################################--#################################################################----################--------#######------#-#--#-#---pP------#-#--#-#########--------#-#
