-----------------------#-pP-------------------pP-----------------------------------------------------------------------------------------------------------------------------------------------------------
------------------------#pP----------C--------pP-----------------------------------------------------------------------------------------------------------------------------------------------------------
-------------------------#######################--#######-----------------------------------------------------------------------------------------------------------------------m--------------------------
---------------------------------------------------------------------------------------------------------------------------------------------------------------------------------m-------------------------
-------------------------------------------------------------------------------------------------------------------------------------------------------m----------------------mm--m------------------------
-----------------------------------------------------------------------MM-----------------------------------------------------------------------------m-m--------------------m##---m-----------------------
-----------------------------------------------------------------------------------------------------------------------------------------------------m#--m------------------m###----m---------------------m
----------------------mm?---------------------------------------------------------------------------------------------------------------------------m##---m----------------m####-----m-------------------m#
---------------------m##mo--------------------------------------------------------B-----------------------mmmmm------------------------------------m###----m--------------m#####------m-----------------m##
--------------------m##-----------mm-------mm----mm--------------------?????M------BBB--------------------m#BB-m----------------------------------m####-----m------------m######-------m---------------m###
-------------------m###--m------mmm-m-----mm-mmm-m-m------------mmmm----------mmmm-----mmmm-------------mm-#----m--------K-------h-------------Kmm#####------m-----------m######--------mm-m----------m####
------------------m####---------m?---m----m----Vm---m----mm-----m[]-m-----mm--m[]-m----m[]-m---mm-------m#-#-----m-------K-------Kmm-----------m#######-------mm--------m#######--------#-m-mmmmmmmmmm#####
--mmmmmmmmmmmmmmmm#####---mmmmmm?-----mmmm-----[]----mmmmB-mmmmm-pP--mmmmmh-mm-pP--mmmm-pP--mmmh-mmmmmmm-#-#------mmmmmmmmmmmmmmmmh-mmmmmmmmmmmm#######-------#-mmmmmmmm########-##########################
########################--[]-#-#-------#-#-----pP-----#-#---#####################################################################################################################--------------------------
