-----------------------------------------------------------------------------------------------------------------------------------------------------------------------------------------------------------
-----------------------------------------------------------------------------------------------------------------------------------------------------------------------------------------------------------
-----------------------------------------------------------------------------------------------------------------------------------------------------------------------------------------------------------
---------------------------------------------------------------------------------------mm---------m--------------------------------------------------------------------------------------------------------
--------------------------------------------------------------------------------------mm-mmm---mmm-m-------------------------------------------------------------------------------------------------------
----------------------mm-------M------------?BBBBM?----------------------------------mm-----m-m###--m----------------------m-------------------------------------------------------------------------------
---------------------m#-m-----------------------------------------------------------mm-------m####---m--------------------m-m---------------------------------------------------------------mm-------------
--------------------m##--m-----------------m---------------------------------------mg--------#####----m------------------m#--m-------------------------------------------------------------mm-m-----------m
-------------------m###---m-------------mmm-m----------------m---------------------m#-------######-----m----------------m##---m---------mm------------------------mm--------mm---------mm--m---m---------mm
------------------m####----m---?-------mm[]--m--?????M??------mmm-----------------m##------#######------m--------------m###----m?------mmVmm---?????------------mm#-m------mm-mmm-----mm-mm-----m-------mm-
-----------------m#####-----m---------mm-pP---m--------------m?#-m----mmmm-------m###------#######-------m------------m####-----m-----mm-[]-m------------------m[]#--m----mmY----m---mm---B------m------m--
----------------m######------m--------m--pP----mm------------m-#--m---m[]-m-----m####-----########--------mm-m-mm-m--m#####------mm-m-m--pP--m-----------------mpP#---m---m-y-----m--m------------mmmmmm---
--mmmmmmmmmmmmmm#######-------mmmmmmmm---pP----ggmmmmmmmmmmmm--#---mmm-pP--mmmmm#####----#########--------#-m-m#-m-mm######------#-m-m---pP---mmmmmmmmmmmmmmmmmmpP#----mmm--#------mm------------#######---
################################################################--###########################################################################################################------##----------------------
