---------------------------------------------------------------------------------------------------------------------------------------########------------------------------------------------------------
-----------------------------------------------------------------------------------------------------------------------------------------------------------------------------------------------------mm----
----------------------------------------------------------------------------------------------------------------------------------------------------------------------------------------------------mm-m---
----------------------------------------------------------------------------------------------------------------------------------------------------------------------------------------------------m---m--
--------------------------------------------------------------------h-hhh------------------------------------mmmm-----------------------------------------------------------------mmmmmmmmmmmmmmmmmm-----m-
---------------------------------------BBBBM?---------------------BBBBBBBBB*M-------------------------------m##?-m---------------------------------------------------------------m##################------m
-----------------------------------------------------------------------------------------M-----------------m###---m-------------------------------------------------------------m##------------------------
----------------------------------------------------------------------------------------------------------m####----m---------------------------mmmm----------------------------m###------------------------
----------------------------------mmmm--------------------------------h----------------------------------m#####?----m-----------mm------------m#BB-m------------mm------------m####------------------------
---------------------------------mm[]-m--?????--------------------BBBBBBBBBBB------------mm-------------m######------m---------mmVmm---B-----m##----m-----mm----m-m----------m#####------------------------
--------------------------------mm-pP--m------?------mmmm----mmmm-----------------------m#-m-----------m#######-------m-------mm-[]-m-------m###-----m--mmm-mmmm---mmmmmmmmmm######------------------------
--------------------------------m--pP---m------------m[]-m---m[]-m---------------mm-----m#--m-mmm-----m########--------mm-m---m--pP--m-----m####------m-mm----##---################------------------------
--mmmmmmmmmmmmmmmmmmmmmmmmmmmmmm---pP----mmmmmmmmmmmm-pP--mmm-pP--mmmmmmmmmmmmmmmh-mmmmmm#---mgk-mmmmm#########--------#-m-mmm---pP---mmmmm#####-------m---------------------------------------------------
###################################################################################################################################----##-######-------#---------------------------------------------------
