--------------------------------------------------------------------------------------------------------------------------------------------------##########--------###--------#################-----------
--------------------------------------------------------------------------------------------------------------------------------------------------------------------##########-----------------------------
---------------------------------------------------------------------------------------------------------------------------------------------------------------mm------------------------------------------
--------------------------------------------------------------------------------------------------------------------------------------------------------------mm-mmm---------------------------------------
--------------------------------------------------------------------------------------------------------------h----------------------------------------------mm-----m--------------------------------------
------------------BB--------------BBBBO---------------------------------------------------------------BBBBBBBBB----------------------------------------------m----------m----------------------------------
-----------------B---------------M--B-------------------------------M----------------------------------------------------------mm---------------------------m--------mmm-m---------------------------------
-------------------------------------------------------------------------------------------------------------------------------m-mm------------------------m#--------###--m----------------------m---------
-------------mm---B-------------------------------------------------------------------------------mm-----------h--------------m-##-m----------mm----------m##--------###---m--------------------m-m--------
------------mm-mm--?----mm--------mm--?-------mm-------??????-------mm---------------------------mm-mmmmm--O?BBB--mm---------mM-##--m--------mm-mmm------m###--------###----m------------------m#--m-------
-----------mm----m-----mC-m------mC-m--------mC-m------------------m#-m----------mmm------------mm----[]-m-------mm#m--------m--##---m------mm-----m----m####--------###-----m----------------m##---m------
-----------mC----cm----mc--m-----mC--m----K--mC--m------------mmK--m#--m---------m#-m----mm-----m-----pP--m------m-#-m-------m--##----m-----mC------m--m#####--------###------m----m----m----m###----m-----
--mmmmmmmmm-c----c-mmmmmc---mmmmmmC---mmmmmmmmC---mmmmmmmmmmmmC-mmmm#---mmmmmmmmm-#--mmmmh-mmmmm------pP---mmmmmm--#--mmmmmmmh--##-----mmmmm-c-----#-mm######--------###-------mmmm-mmmm-mmmm####-----mmmmm
#################################################################################################################--#############################---#--#######--------###--------#-#--#-#--#-###############
