-----------------------------------------------------------------------------------------------------------------------------------------------------------------------------------------------------------
--------------------------------------------------------------------------------------------------------------------------------------------------------------------------------------mmm------------------
-----------------------------------------------------------------------------------------------------------------------------------------------------------------------------------------mm----------------
--------------------------------------------------------------------------------------------------------------------------------------------------------------------------------------m--#-m---------------
--------------------------------------------------------------------------------------------------------------------------------------------------------------------------------------m--#--m--------------
----------------------------------------------------------------------------------------------------------------------B---------------------------------------------------------------m-##---m-------------
-------------------------------------------------------------------------------------------------------------------------------------------M--------------mm-------mm-----------------m-##----m------------
---------------------------------------------------------------------------------------------------------------------------------------------------------m#-m-----mmVmm---------------m-##-----m-----------
------------------------------------------------------------------------------------------mm------------------------------------------------------------m##--m---mm-[]-m--------------m-##------m----------
------#------------------------mm---------mm-----???----mm----?M??----mm-----------------mm-mmmmm---------------------mmm----BBBB----------mm----------m###---m--m--pP--m-------------m-##-------m-----mmm-
---------------------mmm------mC-m-------mC-m----------mC-m--K-------mC-m-------mm---K--mm----[]-m-------------------m[]-m----------------m#-m--------m####----mm---pP---m-----------mm-##--------mm-m-mC-m
---------------------mC-m--K--mc--m------mC--m---------mc--m---------mc--m-----mC-m------C----pP--m------------------mpP--m----mm---------m#--m------m#####---########----m----------mY-##--------#-m-m-c--
--mmmmmmmmmmmmmmmmmmm-c--mmmmmmC---mmmmmmmC---mmmmmmmmmmC---mmmmmmmmmmC---mmmmmmC--mmmmmmC----pP---mmmmmmmmmmmmmmmmmmmpP---mmmmh-mmmmmmmmmm#---mmmmmm######----------------mmmmmmmmmm-y--#################-
###########################################################################################################################################################-------------##-############-#------------------
