--------------------------------------#####----------#---#####---------#------#---######---------#-#--#---------#-#-################################################################################-------
-------------------------------------#################-############################################################----------------------------------------------------------------------------------------
-----------------------------------------------------------------------------------------------------------------------------------------------------------------------------------------------------------
-----------------------------------------------------------------------------------------------------------------------------------------------------------------------------------------------------------
-----------------------------mm----------------------------------------------------------m-----------------------------------------------------------------------------------------------------------------
----------------------------mm-m-----------------------------------------------------mmmm-m--------------------------------------------------------------------------------mm------------------------mmm---
---------------------------mm---m-------------------------------------------------mmm####--m------------------------------------------------------------------------------mm-mmm--------------------mBB-m--
---------------------------m-----m------------------------------------------------m-#####---m-------------------------------mm----------------------mmm----------------mmmm-----m-------------------m----m-
--------------------------m------------*----------------------mm-----------------m-######----m-----------------------------m#-m--------------------m#B-m--------------m#BB-------m-----------------m#-----m
-------------------------mC-------m---B----mm----------------m#-m---------------mm-######-----m---------------------------m##--m------------------m##---m------------m##----------m---------------m##----B-
----------------mmm---K--mc--------m-----mmh-m--------------m##--m--------------m?-######------m-------------------------m###---m----------------m###----m----------m###-----------mmm-----------m###------
----------------mC-m-----mc-------Y-m---m###--m------------m###---m------------m---######-------m----mm-m---------------m####----m-----m----mm--m####-----m----m--mm####-----------[]-m----mm---m####------
--mmmmmmmmmmmmmm-c--mmmmmmc-------y--mmm####---mmmmmmmmmmmm####----mmmmmmmmmmmm#---######--------mmmm#-m-mmmmmmmmmmmmmmm#####-----mmmmm-mmmm#-mm#####------mmmm-mm######-----------pP--mmmm#-mmm#####------
###################################---######----##-#-##-#######-----##-##-#-#-##---######---------#-#--#--#-#-#-####-#-######------##-#--#-#---######-------#-#--#-#####-----------pP---#-#--#-######------
