-----------------------------------------------------------------------------------------------------------------------------------------------------------------------------------------------------------
-----------------------------------------------------------------------------------------------------------------------------------------------------------------------------------------------------------
-----------------------------------------------------------------------------------------------------------------------------------------------------------------------------------------------------------
-----------------------------------------------------------------------------------------------------------------------------------------------------------------------------------------------------------
-----------------------------------------------------------------------------------------------------------------------------------------------------------------------------------------------------------
------------------------------------------------------------------------------------------------------------BBBBBB-----------------------------------------------------------------------------------------
----------------------------------------------------------------------------------------mm-----------------------------------------------------------------------------------------------------------------
----------------------------------------------------------------------------------mm----m-m----------------------------------------------------------------------------------------------------------------
---------------------------------------------------------------------------------mm-mmmm---m------------------h--h-----------------------------------------------------------------------------------------
-----------------------------mm---????????-----------mm----------mm----BBB???---mm----[]----mmm-------------BBBBBB-----------------------------------------------------------------------------------------
-------------------mmm------mC-m------K------Kmm----mC-m--------mC-m-----------mm-----pP----[]-m-----mmmm----------mmm-------------------------------------------------------------------------------------
-------------------mC-mK----mc--m---------K--mC-m---mc--m-------mc--m---------mmC-----pP----pP--m----m[]-m-----mm---#-m-------------mm----------------------------h---------------h------------------------
--mmmmmmmmmmmmmmmmm-c--mmmmmmC---mmmmmmmmmmmmmc--mmmmc---mmmmmmmmC---mmmmmmmmmh-c-----pP----pP---mmmm-pP--mmmmmh-mmm#--mmmmmmmmmmmmmh-mmmmmmmmmmmmmmmmmmmmmmmmmmmmmmmmmmmmmmmmmmmmmmmmmmmmmmmmmmmmmmmmmmmmm
###########################################################################################################################################################################################################
