----------------------------------------------------------------------------------------------------------------------------------------------------------------------------#-k####---##################---
----------------------------------------------------------------------------------------------------------------------------------------------------------------------------###############################
-----------------------------------------------------------------------------------------------------------------------------------------------------------------------------------------------------------
-----------------------------------------------------------------------------------------------------------------------------------------------------------------------------------------------------------
--------------------------------------------------------------------------------------------------------------------------------------------------------------------------------------mmmm-----------------
-----------------------------------------------------------------------------------------------------------------------------------------------------------BBBBBBBBB-----------------mm--------------------
-----------------------------------------------------------------------------------------------------------------------------------M------------------------------------------------mm---------------------
------------------------------------------------------------------------------------------------------------------------------------------------------------------------------------m----------------------
-----------------------------------------mm-----------------------------mm----------------------------------------------------------------------------mm--------------mmm----------m-----------------------
----------------------------------------mm-m--?BBBB---mmm--------------mm-mmmmm-------------------------------------mmm--??????----mm----------------mm#mm?BBBBBBBB#-mmB-m--------m#--------------------mm-
---------------------mmm--------mm------m---m--------m[]-m---mmm-------m----[]-m-----------------------------------m[]-m----------m#-m--------------mm-#--m---------mm--B-m------m##-------#mmmmmmmmmmmmh-m
---------------------mC-m------mC-m----mC----m--mm---mpP--m--mC-m-----mC----pP--m-------mm------mm------------mm---mpP--m---------m#--m----mmm------m--#---m----mm--m------m----m###----##-##############--
--mmmmmmmmmmmmmmmmmmm-c--mmmmmmmc--mmmmmc-----mmh-mmmmC#---mm-c--mmmmmmc----pP---mmmmmmmh-mmmmmmh-mmmmmmmmmmmmh-mmmmpP---mmmmmmmmmm#---mmmmgg-mmmmmm---#----mmmmh-mm--------mmmm####----#################--
####################################################################################################################################################################---------#-#####---##################--
