-----------------------------------------------------------------------------------------------------------------------------------------------------------------------------------------------------------
-----------------------------------------------------------------------------------------------------------------------------------------------------------------------------------------------------------
----------------------------------------------------------------------------------------------------------------------------------------------------------------------------mm----B------------------------
---------------------------------------------------------------------------------------------------------------------------------------------------------------------------mm-m----B-----------------------
---------------------------------------------------------BBBBM------------------------------------------------------------------------------------------------------------mm---m---------------------------
-----------------mmm------------------[]-------------------------------------------------------M--------------------------------------------------------------------------m?----mmm------------------------
---------------mm#BBm-----------------pP---------------------------------------------------------------------------------------------------mmm---------------------------m------[]-m-----------------------
----------------##---mm----------mmm--pP--------------mmmm-----------------------------------------------------------------mmm-B----------mm#-m--------mm-------mm------m#------pP--m----------------------
---------------m##--BB-m--------mm[]mm??----?????M---mm[]-m--------?---------------------------mm-------------------------m##-?-BBBBB-----m?#--mmmmmmmmk-mmmmmmmk-mmmmmmm#------pP---m----------???--------
--------------m###------m------mm-pP--m-------------mm-pP--m----------------------------------m#-m---------------------mmm###-m----------m--#--################################## ----m--------------------
-------------m####-------m-----m--pP----mm----------m--pP---m----------------h----------------m#--m-------------------m######-----------m#--------------------------------------##-----m-------------------
------------m#####--------mmmmm---pP---mk-mmmmmmmmmm---##----mmmmmmmmmmmmmmmmmmmmmmmmmmmmmmmmmm#---mmmmmmmmmmmmmmmmmmm#######--mmmmmmmmmm-------------------------------------------##--mmmmmmmmmmmmmmmmmmm
--mmmmmmmmmm#####-########################################################################################################################-------------------------------------------######################
##################-----------------------------------------------------------------------------------------------------------------------------------------------------------------------------------------
