-----------------------------------------------------------------------------------------------------------------------------------------------------------------------------------------------------------
-----------------------------------------------------------------------------------------------------------------------------------------------------------------------------------------------------------
-----------------------------------------------------------------------------------------------------------------------------------------------------------------------------------------------------------
-----------------------------------------------------------------------------------------------------------------------------------------------------------------------------------------------------------
-----------------------------------------------------------------------------------------------------------------------------------------------------------------------------------------------------------
-----------------------------------------------------------------BBBBBBBBBBBB????M-------------------------------------------------------------------------------------------------------------------------
-----------------------------------------------------------------------------------------------------------------------------------------------------------M---------------------------------------------mm
------------------------------------------------------------------------------------------------------------------------------------------------------------------------------------------------------mmm#-
--------------------------------mm------------------------mmm------h--mm-----------------------------------------------------------------------------------------------------------------------------mm###-
-------------------------------mm-mm---------------------mm[]mm--BBBBmm-m--????????----------mmm---------------------------------mm------------------------mm----------------------------------------m####-
--------------------mmm-------mm----mmm-----------------mm-pP--m----mm---m------------------m[]-m-----mmmm----------------------m#-m-----m----------------m#-m--------------------------------------mh####-
--------------------mC-m--K---mC----[]-m-----------mm---mC-pP---m---m-----m-----------------mpP--m----m[]-m----------mm---------m#--m---m-mm-------mmm----m#--m-----mmm----------------------------m######-
--mmmmmmmmmmmmmmmmmm-c--mmmmmm-c----pP--mmmmmmmmmmmh-mmm-c-pP----mmm-------mmmmmmmmmmmmmmmmmmpP---mmmm-pP--mmmmmmmmmmh-mmmmmmmmmm#---mmmk-k-mmmmmmmgg-mmmmm#---mmmmmgk-mmmmmmmmmmmmmmmmmmmmmmmmmmmmm-#####-
###########################################################################################################################################################################################################
