-----------------------------------------------------#####################################################################--###########################################--------------#---------------------
--------------------------------------------------------------------------------------------------------------------------------------------------------------------------------#----#---------------------
--------------------------------------------------------------------------------------------------------------------------------------------------------------------------------###--#---------------------
-------------------------------------------------------------------------------------------------------------------------------------------------------------------------------------#---------------------
------------------------------------------------------------------------------------------------------------------------------------------------------------m----------------------------------------------
--------------------------------------------------------------------mmm----------------------------------------------------------------------------------mmm-m---------------------------------------------
-------------------------------------------------------------------m##-m--------------------------------------------------------------------------------m###--m-------------------------------------------m
---------------------------------------------------mm-------------m###--m------------------------------------------------------------------------------m####---m-----------------------------------------m#
------------------------mmmmm---------------------mm-mm----------m####---m------------------------------------------------mm--------------------------m#####----m--------mm-----------------------------m##
------------------------m???-mm-------------------m--B----------m#####?---m--------------mmm--oo-------------------------m#-m------------------------m######-----m------mm-mmm-------mm-----mm---------m###
----------------------mm-----C-m---------mmm----mm-----mm------m######-----m------------mm[]mm--------------------------m##--m----------------------m#######------m----mm-----m-----mm-m---mm-m-------m####
----------------------mC-----c--m--------mC-m---mC-----C-m----m#######------m-----m----mm-pP--m----------m----mm-------m###---m------mm----m-------m########-------m---m-------m----m-k-m--m---m-----m#####
--mmmmmmmmmmmmmmmmmmmm-c-----c---mmmmmmmm-c--mmm-c-----c--mmmm########-------mmmmm-mmmm#--pP---mmmmmmmmmm-mmmm#-mmmmmmm####----mmmmmm#-mmmm-mmmmmmm########---------mmm---------mmmm--#--mm-----mmmmm######
######################################################-c---#-#########-------#-#-#--#-#---pP----#-#-#-#-#--#-#--#-#-#-#####-----#-#-#---#-#-k-#-#-##########--------#-#----------#-#--#---#------##########
