------------------------------------pP-------pP-------##-------------###-----------------------------------------------------------------------############################################################
------------------------------------pP-------pP-------##------------####---------------------------------######------################----------############################################################
------------------------------------pP-------pP-------##----------######----------------------------------------------------------------------#############################################################
-------------------------################----pP-------##---------#######----------------------------------------------------------------------#############################################################
---------------------------------------------pP-------##--------########-#-------------------------------------------------------------------###--#########################################################
-------------------------------------------########################################----------------------------------------------------########------######################################################
------------------------mm---------------------------------------------------------#####--------------------------------------------------------m-----#####################################################
--------------------mm-mm-m----------------------------------------------------------------######----------------------------------------------------------------------------------------------------------
-------------------m#Bmm---m---------------------------------------------m-------------------------------------------------------------------mmm----mmmmmmmmmmmmmmmmmmmmmmmmmmmmmmmmmmmmmmmmmmmmmmmmmmmmmmm
------------------m####-----m----------------------------m-----mm---------m----------------------------mm-----------------------------mm----mm-----m#######################################################
-----------------m###--------m---mm---------------mm----m-m---mm-mmm----m--m---mm---mm---mm------mm---mm-mmmm-----mm-----------------mm-m---m-----m########################################################
----------------m####---------m--m-mm-----mm--m---m-m--m#--m--m-----m--m#---m--m-m--m-m--m-m--m--m-m--m------m----m-m----------------m---mmm-----##########################################################
--mmmmmmmmmmmmmm#####----------mm----mmmmmm-mmVmmm---mm##---mm-------mm##----mm---mm---mm---mm-mm---mm--------mmmm---mmmmmmmmmmmmmmmm------M-----##########################################################
#######################---------#----[]-##---#[]-#----###----#--------###-----#----#----#----#--#----#---------#-#----#-#-#-#-#-#-#-#-----------###########################################################
