------------------------------------------------------------------------------------------------------------------------------------------------------------------------------------------#################
-----------------------------------------------------------------------------------------------------------------------------------------------------------------------------------------------------------
-----------------------------------------------------------------------------------------------------------------------------------------------------------------------------------------------------------
-----------------------------------------------------------------------------------------------------------------------------------------------------------------------------------------------------------
-----------------------------------------------------------------------------------------------------------------------mm----mm----------------------------------------------------------------------------
-----------------------------------------------------------------------------------------------------------------------mgmmmmm-m---------------------------------------------------------------------------
----------------------------------------------------------------------------------------------------------------------m#g#??M---m--------------------------------------------------------------------------
------------------mm-------------------------------------------------------------------------------------------------m####-------m-------------------------------------------------------------------------
-----------------m#--#-------------mm---------------------------------mmm---+---------------------------------------m#####--------m------------------------------------------------mmm---------------------
----------------m##-m#------------mm#mmBBB-------mm------------------mm[]mm---------------------------mmm----------m######?--------m----------------------------------------------mm##mmm------------------
---------------m###--#-----------mm-#--m--------m+-m------Kmm-------mm-pP--m-----???-----------------m[]-m--------m#######----------mm-------------------------------------------mm-##---m-----------------
--------------m####--m-----------m--#---m--mm---m---m-----m#-m----K-m--pP---m-------mmm--------------mpP--m------m########----------#-m--mm-m------------------------------------m--##----m---m----m----m--
--mmmmmmmmmmmm#####---mmmmmmmmmmm---#----mmm-mmmm----mmmmmm#--mmmmmm---pP----mmmmmmmgg-mmmmmmmmmmmmmmmpP---mmmmmm#########----------#--mm#-m-mmmmmmmmmmmmmmmmmmmmmmmmmmmmmmmmmmmm---##-----mmm-mmmm-mmmm-mm
#######################################################################################################################################################################################----#-#--#-#--#-#--#
