------------------------------------------------#######--#########################################################-----------------------------------------------------------------------------------------
------------------------------------------------------------------------------------------------------------------#----------------------------------------------------------------------------------------
-------------------------------------------------------------------------------------------------------------------#---------------------------------------------------------------------------------------
--------------------------------------------------------------------------------------------------------------------###------------------------------------------------------------------------------------
------------------------------------------------------------m-------------------------m--------------------------------------------------------------------------m-----------------------------------------
-------------------------m---------------------------------m-m----------------------mm-m---------------------------------------------------#--------------------m-m----------------------------------------
------------------------m#mm-----------------------------mm#--m--------------------m##--m-----------------------mm---------------------------------------------m#--m----------------------------------M----
----------------------mm##B-m---------------------------mm##---m------------------m###?--m---------------------m#-m------------------------------------------mm##---m--------------------------------------
---------------------mg###---m-----------mm-------------m-##----m----------------m####----m-------------------m##?------------------mm------------------------###----m-------------------------------------
-------?-??----------m####----m---------mm-mmm--------mm--##-----m--------------m#####-----m-----------------m###--m-----mm--------mm-mmm--------------------m###-----m-------------------------------mm---
---------------------m####-B---m-------mm-----m------m##--##------m------------m######------m---------------m####-?-m---mm-mmm----mm-----m------------------m####------m-----------------mmm---------m#-m--
--------------------m#####------mm-m---m-------m----m###--##-------m-------m--m#######-------m-----m----m--m#####----m--m-----m---m-------mm-m---mm--------m#####-------mm-m-mm-m--------mC-m--------m#--m-
--mmmmmmmmmmmmmmmmmm######------#-m-mmm---------mmmm####--##--------mmmmmmm-mm########--------mmmmm-mmmm-mm######-----mm-#-----mmm--------#-m-mmmk-mmmmmmmm######-------#-m-m#-m-mmmmmmmm-c--mmmmmmmmm#---m
##########################################-------#-#####--##--------#-#-#-#--#########--------#-#-#--#-#--#######------#-----#####--------#################################################################
