-------------------------------#-#####################--------------#---------------------------------------------#------------------------------------####################################################
-------------------------------mm-----------------------------------################------------------------------#-----------------#########--------------------------------------------------------------
------------------------------mm-m-------------------------------------------------------------------------------##--#-------------------------------------------------------------------------------------
------------------------------m---------------------------------------------------------#------------------------------------------------------------------------------------------------------------------
-------------------------m---m----mmm------m---------------------------------------------------------------------------------------------------------------------------------------------------------------
-------------------------mmmmm-#-----m---mm-m--------------------------------------------------------------------------------------------------------------------------------------------------------------
------------------------m-#??M----------m##--m----------------------------------------------------------------------------------------------------------------------------BBBBB----------------------------
------------------------mg#-----------mm###---m----------------------------------------------mm-------------------------------------------------mm---------------------------------------------------------
-----------------------m###-----------#####----m--------mm-----------------------------------m-m----------------------mm--------mm-------------mm-m--------------------mm----m-----------------------------
----------------------m####----------######-----m------mm-mmm------------------------------mm---m-----mm-------------mm-mmm----mm-mmm----------m---m------------------m#-mmmm-mm---------------------------
---------------------m#####----------######------m----mm-----m---mm------------------------m#----m---mm-mmm---mm----mm-----m--mm-----m-------mm-----m----------------m##-BBBBBB-m--------------------------
--------------------m######-------#########-------m---m-------m--m-m----------------m--m--m-------m--m-----m--m-m---m-------m-m-------m------m#------m------m----m--m###--B------m----------mm---------mm--
--mmmmmmmmmmmmmmmmmm#######-------#########--------mmm---------mm---mmmmmmmmmmmmmmmmmmm-mm#--------mm-------mm---mmm---------m---------mmmmmm---------mmmmmm-mmmm-mm####----------mmmmmmmmmm#-mmmmmmmmm#-mm
###########################################--------#-#----------#----#-#-#-#-#-#-#-#--#--#----------#--------#----##---------#----------#-#-#----------#-#-#--#-#--#####-----h-h---#-#-#-#-#--#-#-#-#-#--#-
