-----------------------------------------------------------------------------------------------------------------------------------------------------------------------------------------------------------
-----------------------------------------------------------------------------------------------------------------------------------------------------------------------------------------------------------
-----------------------------------------------------------------------------------------------------------------------------------------------------------------------------------------------------------
-----------------------------------------------------------------------------------------------------------------------------------------------------------------------------------------------------------
-----------------------------------------------------------------------------------------------------------------------------------------------------------------------------------------------------------
-----------------------------------------MBBB---------------------------------------------------------------------------------------mm---------BMMMBM------------------------------------------------------
---------------------------------------------mm------------------------------------------------------------------------------------mm-mm------------------------------B------------------------------------
--------------------------------------------mm-m----------------------------------------------------------------------------------mm----mm-----------------------------------------------------------------
-------------------mm--m-------------------mm---m---------------------------------------mm----------------------------------------m-------m----------------------------------------------------------------
------------------mm-mm-m-----------------mm-----mm---------------------------BB-------mm-mm-------------------------------------m------[]-m---BBBBB------------------mm-----------------------------------
-----------------mm------m---mmm---------mC------C-m------mmm----------mmm------------mm----mmm-------------------------mmm-----mC------pP--m------------------------m#-m----------------------------------
-----------------m--------m--mC-m--------mc------c--m-----mC-m---------mC-m-----mm--K-mC----[]-m-----mm---mm------mm----hC-m----mc------pP---m------------mm---------m#--m--mm--------mm--------------mm---
--mmmmmmmmmmmmmmm----------mm-c--mmmmmmmmmpP-----c---mmmmm-c--mmmmmmmmm-c--mmmmmh-mmmm-c----pP--mmmmmh-mmmh-mmmmmmh-mmmmmc--mmmmmc------c ----mmmmmmmmmmmmh-mmmmmmmmmm#---mmk-mmmmmmmmg-mmmmmmmmmmmmmmh-mmm
#####################-----#################################################################################################################################################################################
