--------------------------------------------------------------------------------#########################################-----######################################################################-------
---------------------------------------------------------------------------------------------------------------------------------------------------------------------------------------------------########
-----------------------------------------------------------------------------------------------------------------------------------------------------------------------------------------------------------
-----------------------------------------------------------------------------------------------------------------------------------------------------------------------------------------------------------
-------------------------------------------------------------h--------------mm---------------------------------------------------------------------------------------------------------m-------------------
-------------------------------------------------------BBBM???????-----BBBBmm-m----------------m-------------------------------------------------------------------------------------mm-m------------------
--------------------------------------------------------------------------mm---m--------------m-m--------------------------------------m--------------------------------------------m##--m-----------------
-------------------------------------------------------------------------mm-----m------------m#B-m------------------------------------m-m------------------------------------------m###---m----------------
-----------------------------------------------mm-------hh---------------m------------------m##---m----------------------mm----------m#--m----------------------------------------m####----m---------------
------------------------------mm----??????----mm-mmm--BBBBBBBBBBB?-----mm?-------mm--------m###----m----------------mmmmm#-m--------m##---m------------------mmm-----------------m#####-----m--------------
-------------mmm-------mm----mC-m---K--K-----mm--[]-m-----------------m[]--------V-m------m####-----m--------------m######--m---#--m###----m----------------mm[]mm--------------m######------m-------------
-------------mC-m-----mC-m---mc--m------------C--pP--m----------------mpP--------c--m----m#####------m---m----m---m#######---m----m####-----m-----------m---m-pP--m----m----m--m#######-------m---mm-------
--mmmmmmmmmmm-c--mmmmmmc--mmmmc---mmmmmmmmmmmmC--pP---mmmmmmmmmmmmmmmmmpP--------c#--mmmm######-------mmm-mmmm-mmm########----mmmm#####------mmmmmmmmmmm-mmm--pP---mmmm-mmmm-mm########--------mmm#-mmmmmmm
###################################################################################---#-#######-------#-#--#-#-#-#########-----#-######------#-#-#-#-#-#---#--pP----#-#--#-#--#########--------#-#--#-#-#-#
