-----------------------------------------------------------------------------------------------------------------------------------------------------------------------------------------------###--#######
------------------------------------------------------------------------------------------------------------------------------------------------------------------------------------------------##--------#
-----------------------------------------------------------------------------------------------------------------------------------------------------------------------------------------------------------
---------------------------------------------------------------------------------------------------------------------------------------------------------------------------------------------------------mm
---------------------------------------------------------------------------------------B----------------------------------------------------------------------------------------------------------------mm-
-----------------------Bmm-----------------------------------------------------------mm-B---B----------------------------------------------------------------------------------------------------------mm--
------------------------B-m---------------------------------------------------------mm-mmm-----------------------------------------M------------mm--------------------------------------------------mm-m---
-----------------------m---m-------------------------------------------------------mm-----m----------------------------------------------------m#-m------------------------------------------m-mm--mm-m----
----------------------mm-----------------------------------------------------------m-------m--------------------------------------------------m##--m-----------------------------------mmmmmm-mmmm-m-##----
----------------------mO----mm-------------------mm-------------------------------m----BB---m---BBBBB--mmm-------------------------mm--------m###---m-------------mm------------------m######h----m--##----
-----------mmm-------mm-----C-m-----------------mC-m--------mmm----mmm-----mm----mC----------m---------m#-m-----------------------m#-m------m####----m-----------m?-m---mmm---------mm#########--##--##----
-----------mC-m------mC-----c--m----------------mc--m-------mC-m----C-m---mC-m---mc---------Y-m--------m#--m--mm-----------mm-----m#--m----m#####-----m----------m---m--mC-m---K---mC##########--##B-##----
--mmmmmmmmm-c--mmmmmm-C-----c---mmmmmmmmmmmmmmmmmc---mmmmmmm-c--mmmmc--mmmmc--mmmmc----B----y--mmmmmmmm-#---mmk-mmmmmmmmmmmh-mmmmmm#---mmmm######------mmmmmmmmmmm----mm-c--mmmmmmmm###########--##--##----
################################################################################################################################################################################################-##--pP----
