--------------------------#--#----###############--######################################################################-----------------###--------------------------------------------------------------
--------------------------------------------------------------------------------------------------------------------#----#----------------###------------------############--------------------------------
--------------------------------------------------------------------------------------------------------------------------#--------------####--------------------------------------------------------------
-------------------------------------------------------------------------------------------------------------------mm------####---------#####---------#----------------------------------------------------
------------------------------------------------------------------------------------------------------------mm-----m-m--m--------------######--------------------------------------------------------------
-----------------------------------------------------------------------------------------------------------mm-moomm---mm-m-------------######--------------------------------------------------------------
----------------------------mm------------------------------------------------------------B---------------mm---mm?M-#--#--m-----------#######--------------------------------------------------------------
----------------------------m-m--------------------------------------------------------mmmm---------------m-----M-----##----------###################------------------------------------------------------
-------------------------mmm---m---------------------------mmmmm----------------------m#BBmm-------------m------------##---m---------------------------------------------------------mm--------mm----------
----------???-----------m###----m-------mmmmmmmmmmm-------m###BBmmmmmmm--------------m##----m-----------m#------------##---------------------------------mm-------------------------mm-mmm----mm-mmm-----mm
------------------------m#-#--#--m-----m###########m-----m####--BBBBBB-m------------m###--BB-m---------m##-----------###----m---mmm-----------m---------mm-mmm---------------------mm-----m--mm-----m---mm-
-----------------------m##------#-m--mm###########--m---m#####----------m----------m####------m----m--m###-----------###-----m--m#-m--m--------m--m--m--m-----m--------------m-----m-------m-m-------m--m--
--mmmmmmmmmmmmmmmmmmmmm#-#-----##--mm#############---mmm######-----------mmmmmmmmmm#####-------mmmm-mm####-----------###------mm----mm-mmmmmmm--mm-mm-mm-------mmmmmmmmmmmmmm-mmmmm---------m---------mm---
###########################----##---#-############---#-#######------------#-#-#-#-######--------#-#--#####-----------###-------#-----#----####---#--#--#--------#-#-#-#-#-#-#--#######-----#####-------#---
