-----------------------------------------------------------------------------------------------------------------------------------------------------------------------------------------------------------
------------------------------------------------------------------------------------------##--------------------------------mmm----------------------------------------------------------------------------
----------------------------------------------------------------------------------------------------------------------------m--m---------------------------------------------------------------------------
----------------------------------------------------------------------------------------------------------------------------m---m------------------------------------mm------------------------------------
----------------------------------------------------------------------------------------------------------------------------m----m---------------BB-----------------mm-m-----------------------------------
----------------------------------------------------------------------------------------------------------------------------m-----m--------------------------------mm---mm-----mm--------------------------
----------------------------------------------------------------------------------------B-----------------------------------m------m---------mm--------------------m------m----m-m-------------------------
-----------------------------------------------------------------------------------------BB------------------------m--------m-------m-------mm-mmmmmmmmmmmmmmmmmmmm--------m-mm---m------------------------
-------------------------------------mm-------------mm------------------------------------------------------------m-m------mm-#------m-----mm----##################---------mh#----m-----------------------
-----------------------mm-----------mm#mm--?????---mm-mmm------------------------------mm-------mmmm--------------mC-m-----mY-#-------m----mC----##################-------#####-----mmm------??-?---??--?M-
------------mmm-------mC-m-----K---mm-#--m--------mm-----mm---------------------------mm-m-----mmBB-mmmmmmmmmmmmmmmC--mmmmm-y-#--------mmmm-c----##################------######-----[]-m-------------------
------------mC-m------mc--m--------mC-#---m-------mC-----#-m--------------------------m---m----m----#########################-#################--##################------######-----pP--m------------------
--mmmmmmmmmm-c--mmmmmmmc---mmmmmmmm-c-#----mmmmmmm-c-----#--mmmmmmmmmmmmmmmmmmmmmmmmmm-----mmmm--------------------------------------------------##############################-----pP---mmmmmmmmmmmmmmmmmm
##########################################################-###########################------#-#-------------------------------#-----------------------------------------###################################
