------------------------------------------------------------------pP----########----pP-------#####------##------------#--###---------pP--------------------------------------------------------------------
-----------------------------------------------------------------######################################################--###---------pP--------------------------------------------------------------------
---------------------------------------------------###---------B---------------------------------------------------------##################-----------------mm---------------------------------------------
----------------------------------------------------------##--#---------------------------------------------------------------------------------------------m-m--------------------------------------------
-----------------------------------------------------------------------------------------------------------------------------------------------------------m---m-------------------V-----------------------
-------------------------------------------------------------------------------------------------------------------------------------------------mm-------m#----m------------------[]V---------------------
------------------------------------------------B------------------------------------------------------------------------------------------------m-m-----m##-----m-----------------pP[]--------mmmm--------
-----------------------------------------------BBB---------------------------------------------------------------------------------------------mm---m---m###------m----------mmm---pPpP-------mm[]-m-------
-----------------------------------------------------BBBBBBB---------------------mm------------------------------------------------------------m#----m-m####-------m--------mm[]mm???B#BB-----m-pP--m------
--------#-----------mm---????-----mm----B??----mm---BB--------mm-----------------m-m---------------------------------------mmm---------------mm-----#-m#####--------m------mm-pP--m------mmmmm--pP---m-----
-------------mmm---mC-m----------m?-m------K--mm-m------mm---mm-mmm--------mmmmmm---m---o--mmm------------mm------------mmm##-m------mm-m----m#-----########---------mm-m--m--pP---m-----m[][]--pP----m----
-------------mC-m--mC--m-----mm--mC--m-------mm---m----mm-m--m-----mmm----m######----mmm---m?-mmmmm------m#-m-------m---m?###--m--m--mVm-m--m-#----#########---------#-m-mm---pP----mmmmm-pPpP--pP-----mmmm
--mmmmmmmmmmm-c--mmmc---mmmmmh-mmmC---mmmmmmmm-----mmmmm---mm------[]-mmmm#######----[]-mmm---[]pP-mmmmmm##--mmmmmmm-mmm--###---mm-mm-[]--mm#------########################################################
#############################################-------#-#-----#------pP--##########----pP--##---pPpP--#-#-###---##-#-#--##--###----#--#-pP---#---------------------------------------------------------------
