--------------------------------------------------------##############################################################################--##pP----------#------------########################################
----------------------------------------------------------------------------------------------------------------------------------------###############----------------------------------------------------
-----------------------------------------------------------------------------------------------------------------------------------------------------------------------------------------------------------
-----------------------------------------------------------------------------------------------------------------------------------------------------------------------------------------------------------
----------------------------------------------g----------------------------------------------------------------------------------------------------------------------------------m-------------------------
-------------------------------------------BBBM??MM----B----------------------------mmmmm---------------------------mm---------mm----------------------------------------------mm-m------------------------
--------------------------------------------------------BBBB-----------------------m###--m-------------------------mm-mmm-----mm-mm-------------------------------------------m##--m-----------------------
------------------------------------mm----------------------------mm--------------m####---m-----------------------mm---m-m---mm----m----mm-----------------------------------m###---m----------------------
----------------mm----------------mmmVm----------h---------------m#-m------------m#####----m-----------------mm---m-------m--m------m--mm-----------------mm----------------m####----m---------------------
---------------mm-mm----BBBBBB-----m-[]mm--BB?BBBBBB--mm--------m##--m----------m######-----m---------------mm-mmm---------mm--------m-m-kmm-------------mm-mmm--mm--------m#####-----m--------------------
--------------mm----mmm-----------m--pP--m----------Kmm-m------m###---m--------m#######------m-------------mm---[]---------[]--------Vm--##-m-----------mm-----m-m-m------m######------m------------------m
--------------mC----[]-m-----mm--m#--pP---m----------m---m----m####----m------m########V------m---m-----m--m----pP---------pP--------[]--##--m--------m-m-------m---m----m#######-------m---m----m----m--m#
--mmmmmmmmmmmm-c----pP--mmmmmh-mmmC--pP----mmmmmmmmmm-----mmmm#####-----mmmmmm#########[]------mmm-mmmmm-mm-----pP---------pP--------pP--##---mmmmmmmm-m--------#----mmmm########--------mmm-mmmm-mmmm-mm##
#####################################################------########------#-#-##########pP------#-#---#-#--#-----pP------g--pP----t---pP--##[]--#-#-#-#-#--------------#-#########--------#-#--#-#--#-#--###
