----------------------------------------------------------------------------------------------------------------------------------#########################################################################
-----------------------------------------------------------------------------------------------------------------------------------------------------------------------------------------------------------
-----------------------------------------------------------------------------------------------------------------------------------------------------------------------------------------------------------
-----------------------------------------------------------------------------------------------------------------------------------------------------------------------------------------------------------
---------------------------------------------------------------------------------------BBBBBB-B-----------------------------------------------m------------------------------m-----------------------------
------------------------B----------------------------------BBBBBBBBBBBBB---------mm---------BB----------------------------------------------mm-m---------------------------mm-m----------------------------
--------------------------------------------------------------------------------mm-mmm-----------------------------------------mm----------m##--m-------------------------m##--m---------------------------
-------------------------------------------------------------------------------mm-----m---mm----------------------------------mm-m--------m###---m-----------------------m###---m--------------------------
------------------------------------------------------mmm----------------------m-------mmmm-mmm-------------------------------m---m-----mm####----m---------------------m####----m-------------------------
-----------------------mm--------????#--mm-----------mm[]mm-????BBBBBB-------mm--------mmm-----mmm--------------------------mm---------mh#####-----m-------------------m#####-----m------------------------
----------------mmm---mC-m---mmm-----K-mC-m--------Kmm-pP--m----------------m[]----------------##-m------------mm-------K--m[]-----mm-m#######------m-----------------m######------m-----------------------
----------------mC-m--mC--m--mC-m------mc--m--------m--pP---m---------------mpP--------Y------###--m------K---mC-m---------mpP-----c-m########-------m---m------m----m#######-------m---m--------m----m----
--mmmmmmmmmmmmmm-c--mmmC---mm-c--mmmmmmmC---mmmmmmmm---pP----mmmmmmmmmmmmmmmmpP--------y##---####---mmmmmmmmmmmC--mmmmmmmmmmpP-----pP#########--------mmm-mmmmmm-mmmm########--------mmm-mmmmmmmm-mmmm-mmmm
########################################################################################-----#################################################--------#-#--#-#-#--#-#########--------#-#--#-#-#-#--#-#--#-#
