-----------------####################-#####----------------------------------------------------------------------------------------------------------------------------------------------------------------
-----------------------------------------------------------------------------------------------------------------------------------------------------------------------------------------------------------
-----------------------------------------------------------------------------------------------------------------------------------------------------------------------------------------------------------
-----------------------------------------------------------------------------------------------------------------------------------------------------------------------------------------------------------
--------------------------------------------mm-------------------------------------------------------------------BBBBBBBM----------------------------------------------------------------------------------
-------------------------------------------m?-m---------------------------------------------M----------------------------B-----------------------------------------------------------------mm--------------
----------------mm-mmm--------------------m?---m--------------------------------------------------------------------------------------------------------------------------------Mo--mm----mm-m-------------
----------------m-m##-m----------------mmm#-----m-----------------------------------------------------------mm-------------------------mmm-----------------------------------------mm-mmm-m---m------------
--------------mm--###--m---------------mk##------m------------------mm----------O-----------mm-------------mm#mmBBBBBBBBB--mmm--------mm[]mm---------------------------------------m----Vm-----m-----------
-------------m##--###---m-------------mm###-------m------K----------m-m--------mmm---------m#-m-----------mm-#--m---------m[]-m------mm-pP--m------------------------------------mm-----[]------mmm--------
------------m###--###----m------------m?###--------mmmmmmmmmmmmmmmmm---m-------m#-m-K------m#--m---------mm--#---m--------mpP--m-----m--pP---m-----------mmmm-------------------m[]-----pP------[]-m-------
-----------m####--###-----m----m----mm--###-----####################----mmmmmmm-#--mmmmmmmmm#---mmmmmmmmmm---#----mmmmmmmmmpP---mmmmm---pP----m----------m[]-m----------mm------mpP-----pP------pP--m------
--mmmmmmmmm#####--###------mmmm-mmmm##--###-----------------------------##################################################################-----mmmmmmmmmm-pP--mmmmmmmmmmh-mmmmmmmpP-----pP------pP---mmmmmm
################--###-------#-#--#-#-#--###--------------------------------------------------------------------------------------------------#############################################--###############
