-----------------------------------------------------------------------------------------------############################################################################################--###-------#---
---------------------------------------------------------------------------------------------------------------------------------------------------------------------------------------------##############
-----------------------------------------------------------------------------------------------------------------------------------------------------------------------------------------------------------
-----------------------------------------------------------------------------------------------------------------------------------------m-----------------------------------------------------------------
-------------------------------------------------------------------------------------------h-----------------m----------------------------m----------------------------m-----------------------------------
-------------------------------------------------------------mm--------------------------BB??B-------------mm-m------------------------mm--m-------------------------mm-m----------------------------------
------------------------------------------------------------mm-mm-----------------------------BB----------m##--m----------------------m##---m-----------------------m##--m-------------------m---m---------
-----------------------------------------------------------mm----m---------------------------------------m###---m--------------------m###----m---------------------m###---m-----------------mmmmm-m--------
-----------------------------------------------------------m------m-------------mmm--------h------------m####----m------------------m####-----m-------------------m####----m----------------m-k##--m-------
-----------------------------mm--B????------mm----BBBBB---m------V-m-----------mm[]mm----BBB-mm--------m#####-----m----------------m#####------m-----------------m#####?----m-------------mm--###---m------
--------------------mmm-----mC-m----K-K----mC-m----------mC------C--m---------mm-pP--m------mm-m------m######------m--------------m######?------m---------------m######------m-----------m##--###----m-----
--------------------mC-m----mC--m----------mC--m--K------mc------pP--m--------mC-pP---m-----m---m----m#######-------m---m---m----m#######--------m---m----mm---m#######-------m---m-----m###--###-----m----
--mmmmmmmmmmmmmmmmmm-c--mmmmmc---mmmmmmmmmmmc---mmmmmmmmmmc------c----mmmmmmmm-c-pP----mmmmm-----mmmm########--------mmm-mmm-mmmm########---------mmm-mmmm#-mmm########--------mmm-mmmmm####--###------mmmm
#############################################################################################-----#-#########--------#-#-#-#--#-#########---------#-#--#-#--#-#########--------#-#---#-#####--###-------#-#
