---------------------------------------------------------------------------------####################--##-----------pP----------pP---------##############-------------------------------------pP--###------
------------------------------------------------------------------------------------------------------################---------#####----------------------------------------------------------##--###------
--------------------------------------------------------------------------------------------------------------------------------------------------------------#-----------------------------------###------
------------------------------------------------------------------------------------------------------------------------#--------------------------------------#-B---------------------------------##------
------------------------------------------------------------------------------------------------------------------------#---------------------------------------####--------------------------------#######
-----------------------BBBBBBB--------------------------------------------------------------------------------------------------------------------------------------#---###########------------------------
----------------------------------------------------------------------------------BBBBBBBBBBBBBBBB-----------mm------------------------------------------------------###-----------------------------------
------------------------------------------------------------------------------------------------------------mm-mmm------------------------------------------m----------------------------------------------
-------------------mmmmmmmmmmmm------------------------------------------------mmm--------------------mmmmmmm-----m--------------------------------------mmm-mm----------o------------------------m---m----
------------------mm#+BBBBBBBB-m--????#----------#BB*B-----mm-----------------mm#+mmmmmmmmmmmm-------mm###BB-------m---------mm---------mm--------------m#BB-M?mmm------mm-----------o------mm---mmmmm-m---
-----------------mm-#-----------m--KM-K-------mm----------m#-m------m--------mm-#-BBBBBBBBBBB-m------m-###----------m-------mm-m-------mm-m------------m##-----mm-mmm---m-m---mm-----mmm---mm-m--m-###--m--
-----------------m--#------------m-----------m#-m---------m#--m---mm-mm------m--#--------------m----m--###-----------mmm----m---m------m---m---mm-----m###-----------m-----m--m-mo--m---m--m---mm--###---m-
--mmmmmmmmmmmmmmm---#-------------mmmmmmmmmmmm#--mmmmmmmmmm#---mmmgg-k-mmmmmm---#---------------mmmm#--###--B--------[]-mmmm-----mmmmmm-----mmm#-mmmmm####----B-------mm----mm---mmmB----mm----[]--###----m
##################################################################################---------------#-##--###-----------pP--#-#-----[]-#-#-----#-#--k-#######---BBM-------#-----#-----#------#----pP--###-----
