-----------------------------------------------------------------------------------------------------------------------------------------------------------------------------------------------------------
-----------------------------------------------------------------------------------------------------------------------------------------------------------------------------------------------------------
--------------------------------------------------------------------------------------------------------------------------------------------------------------------------mm-------------------------------
-------------------------------------------------------------------------------------------------------------------------------------m-----------------------------------mm-mmm----------------------------
------------------------------------------------------------------------------------------------------------------------------------m-m---------------------------------mm-----m-----------------------mm--
-----------------------------------------------------------------------------------------------------------------------------------m#--m--------------------------------m-------m---------------------mm-mm
--------------------------------------------------?-------------------------------------------------------------------------------m##---m-----------------mmmmmmmmmmmmmm---------m-------------------mm----
---------------------------------------------------------------------------------------------------------------------------------m###----m---------------m#################-------m---------mmmmmmmm-m-----
----------------------------------------mmm--+-----------------------------------------------------------------------------------m###-----m-------------m##------------------------m-------mmBB-----m------
---------------------------------------mm[]m------------------------------------------------------------------------------------m####?-----m-----------m###-------------------------m-----mm--------#------
--------------------------------------mm-pP-m-----????????????--------------mm-----------mmmmmmmmmmmmmmmmmmmmmmmmmmmmmmmmmmmmmmm#####-------m---------m####--------------------------m----m----------------
--------------------------------------m--pP--m-----------------------------m#-m---------m############################################--------mm-m----m#####---------------------------mmmm-----------------
--mmmmmmmmmmmmmmmmmmmmmmmmmmmmmmmmmmmm---pP---mmmmmmmmmmmmmmmmmmmmmmmmmmmmmm#--mmmmmmmmmm#-##########################################--------#-m-mmmm######------------------------##############----------
###########################################################################################################################################################------------------------------------------------
