----------------------------------------------------------------------------------------------------------------------------------------------------------------------#######--------------V---------------
-------------------------------------------------------------------------------------------------------------------------------------------------------------------------------------B-----[]--------------
-------------------------------------------------------------------------------------------------------------------------------------------------------------------------------------------pP--------------
-------------------------------------------------------------------------------------------------m------------------------------------------------------------------------------------#----pP--------------
-------------------------------------------------------h--------------------------------------mmm-m----------------------------------------------------------------------------------------pP--------------
-----------------------------------------?M?BBBB*BBMBBBBBBBBBB*B-----------------------------m###--m------------------------------?--------------------------o------B----------------------pP--------------
--------------------------------------------------------------------------------------------m####---m--------------------------------------------------------BB------BB--------------------pP--------------
-------------------------------------------------------------------------------------------m#####----m---------------------------------------------------------B---------------------------pP--------------
----------------------------------mmm-----------------------------------------------------m######-----m---------mmm----------------------------------------------------------mmmm----------####--mm--------
---------------------------------mm[]m-????BBBBBBBBBBBBBBBBBBBBB-------------mmm---------m#######------m-------mm[]mm????????????-?---------------------??--mm-----mm-------m#BB-m-----------#--mm-m-------
----------------mmm-----Kmm-----mm-pP-m--?----------------------------------m[]-m-------m########-------m-----mm-pP--m-------------------------------------mm-m---mm-m-----m##--B-m-----mm------m---m------
----------------mC-m----mC-m----m--pP--m-----------------------mm-----------mpP--m-----m#########--------mm-m-m--pP---m-------------------mm----------mmm--m---m--m---m--mm###-----mmm--m-m----m-----m-----
--mmmmmmmmmmmmmm-c--mmmmmC--mmmm---pP---mmmmmmmmmmmmmmmmmmmmmmmh-mmmmmmmmmmmmpP---mmmmm##########--------#-m-m---pP----mmmmmmmmmmmmmmmmmmmk-mmmmmmmmmmgg-mm-----mm-----mm#####-----BB-mm---mmmm#------mmmmm
###########################################################################################################################################################------#------######---------#----#-#-------#####
