---------------------------------------------------------------------------------##############################################-------##--------#-------####------------------V ---------------------------
---------------------------------------------------------------------------------------------------------------------------------------############----#####------------------[]----------------------#####
--------------------------------------------------------------------------------------------------------------------------------------------------------####------------------pP---------------------------
-------------------------------------------------------------------------------------------------------------------------------------------------------##########################-----------M--------------
-----------------------------------------------------------------------------------------------------------------------------------------------------------------------------------------------------------
--------------------------------------------------------------------------------------------------------------------------------------mm-m----------------------------------------#------------------------
-----------------------------------------------------------------------------------------------mm------------------------------------mm-m-m----------------------------------------#-----------------------
-----------------------------------------------------------------------------------------------m-m-----------------------------------m-##--m---------------------------m------------######-###-------------
-------------------------------------------------------------------------mm----mm------------mm---m-----------mm-------------------mm--##---m---------mmm--------mm---m-m--o-------------##----------------
-------------------mm--------------BBBBBB------mm-----------mm-----???--mm-mmm-m-m------mmmmmh#----m---------m#-m-----------------m##--##----m--------mY-m------mm-mmmM--mmm-------------------------------
------------mmm---mC-m--K----Kmmm--------mm---mC-m---------mC-m-------Kmm-----m-B-m----m#######-----m-------m##------------------m###--##-----m------m-y--m----mm----M---MM-m----------mm-----mm---mm------
------------mC-m--mc--m-------mC-m------mC-m--mc--m----mm--mc--m-------mC-----B----m--m########------m-----m###--m-------mmm--mmm####--##------m----m###---m---m-------------m------m--m-m-m--m-m--m-m-----
--mmmmmmmmmm-c--mmmC---mmmmmmm-c--mmmmmmmc--mmmC---mmmmh-mmmc---mmmmmmm-c-----------mm#########-------mmmmm####---mmmmmmm##-mm#######--##-------mmmm#----##-mmm---------------mmmmmm-mm---m-mm---mm---mmmmm
###########################################################################----------##########-------#-#-#####---#-#-#-#-#--#-######--##--------#-#-----####-#B---------------#-#-#--#---#--#----#----#-#-
