------------------------------------------------------------------------------------------------------------------#########################################################################################
-------------------------------------------------------------------------------------------------------------------########################################################################################
------------------------------------------------------------------------------------------------------------------m-------------------------------------------#############################################
-----------------------------------------------------------------------------------------------------------------m-mmmmmmmmmmmmmmmmmmmmmmmmmmmmmmmmmmmmmmmmmmm-############################################
--------------------------BBBBBBBB------------------------------------------------------ooooooo------------------m-###########################################m-###########################################
--------------------------------------------------------------------------------------BBBBBBBBBBB?M--------------m-############################################m-##########################################
------------------------mm---------------------------------------------------------------------------------------m-#############################################m-#########################################
-----------------------m#-mmmmmmmmm-----------------------------mmm-mm-------------------------------------------m-##############################################m-########################################
----------------------m##BBBBBBBBB-m----------mm---------------mm[]m--m------------------------------------------m-###############################################m-#######################################
-------------------mmm###-----------m--------mB-m---mmm------Kmm-pP-------------------BBBBBBBBBBBBBB-------------m-################################################m-######################################
------------------m######------------m-------m---m--mC-m-K----m--pP----m-----?M--mm-----------------------------mm-#################################################m-#####################################
-----------------m#######-------------mmmmmmmm----mm-c--mmmmmm---pP-----m--------m-m----------------------------mY-##################################################m-------------------------------------
--mmmmmmmmmmmmmmm##################################################------mmmmmmmm---mmmmmmmmmmmmmmmmmmmmmmmmmmmm-y-###################################################mmmmmmmmmmmmmmmmmmmmmmmmmmmmmmmmmmmmm
#####################-------------------------------------------------###########--###############################-########################################################################################
