-----------------------------------------------------------------------------------------------------------------------------------------------------------------------------------------------------------
-----------------------------------------------------------------------------------------------------------------------------------------------------------------------------------------------------------
-----------------------------------------------------------------------------------------------------------------------------------------------------------------------------------------------------------
-----------------------------------------------------------------------------------------------------------------------------------------------------------------------------------------------------------
---------------------------------------------------------------------mm------------------------------------------------------------------------------------------------------------------------------------
---------------------------------------------------------------------m-m-----------------------------------------------------------------------------------------------------------------------------------
-------------------------------------------------------------------mm---m-------------------------------------------B--------------------------------------------------------------------------------------
-----------------------------------------------------------------m-m#----m---------------------------------------------------------------------------------------------------------------------------------
------------------------mm-------hhh-----------------------------mm-------m------------------------------------------------------mmm-----------------------------------------------------------------------
-----------------------mm-m----BBBBBB-----mm--??????------------m-#--------m----------------------------------------mm----------mm[]mm---------------------------------------------------------------------
----------------------mm---m-------------mC-m----------mmm-----m#-----------m--------mmmm-----------------mmm------m#-m--------mm-pP--m-------?????M??-------------------------------------------------mmm-
----------------------mC----m--------mm--mpP-m---------mC-m----m#------------m-------m[]-m-------mm-------mC-m-----m#--m-------m--pP---m----------------------mm---------------mm---------------------m[]-m
--mmmmmmmmmmmmmmmmmmmm-c-----mmmmmmmmh-mmmc---mmmmmmmmm-c--mmmmmC-------------mmmmmmm-pP--mmmmmmmh-mmmmmmm-c--mmmmmm#---mmmmmmm---pP----mmmmmmmmmmmmmmmmmmmmmmh-mmmmmmmmmmmmmmmh-mmmmmmmmmmmmmmmmmmmmmmpP--
#################################################################------------##############################################################################################################################
