------------------------------------------pP-------#####--------#----##-----------------[]--pP--------[]---------[]##----##---############------[]--pP-----[]---########################--------#----######
------------------------------------------#####################################---------pP--pP--------pP---------pP----------#############------pP--pP-----pP-------------------###########################
---------------------------------------------------------------------------------#------pP--pP--------pP#--------pP----------############################### ----------------------------------------------
---------------------------------------------------------------------------------#########--######---####--------pP----------------------------------------##------------------mm--------------------------
------------------------------------------------------------------------------------------------------#############-----------------------------------------------------------mm-mmm-----------------------
--------------------------------BMBMM?MB---------------------------------------------------------------------------------B---------------------------------------------------mm-----m----m-----------------
----------------------mm---------------------------------mm------------------------------------------------------------B-----------------------------------------------------m-------m--m-m----------------
---------------mm----mm-mmm-----------------------------mB-m--------------BBBB----------------------------------------------------------------------------------------------m---------mm#--m---------------
--------------mm-m---m----Vmm-----h----h--mm-----------m#---m-----------------B--mm------------------------------------mm--------------------------------------------------m#---------t##---m--------------
--------------m---mmm-----[]-m--???BBBBB-mmVmm--------m##----m-------mm---------mm-mmm------mm---------------mm-------mm-mm-----------------------------mm----------------m##---------###----m-------------
------------mm-----[]-----pP--m---------mm-[]-m------m###-----m-----mm-mmmmm---mm-----m----mmVmm------------mm-m-----mm---Vmm--------------------m-----mm-m----mm--------m###--------####-----m-----------m
------------mC-----pP-----pP---m--------m--pP--m----m####------m----m-#--BB-m--m-------m---m-[]-m--mm-------m---m----m----[]-m--mmmmmmmmmmmm--mmmmm----m---m---m-m------m####-----#######------m----m----m#
--mmmmmmmmmm-c-----pP-----pP----mmmmmmmm---pP---mmmm#####-------mmmm--##-----mm---------mmm--pP--mmm-mmmmmmm-----mmmm-----pP--mm###########-mm??B--mmmm-----mmm---mmmmmm#####----########-------mmmm-mmmm##
#########################################--pP----#-######--------#-#--##------#----------##--pP---#----#-#-#------###-----pP---############--#---V--#[]-----V###---#-#-######---#########--------#-#--#####
