-----------------------------------------------------------------------------------------------------------------------------------------------------------------------------------------------------------
-----------------------------------------------------------------------------------------------------------------------------------------------------------------------------------------------------------
-----------------------------------------------------------------------------------------------------------------------------------------------------------------------------------------------------------
-------------------------------------------------------------------------------------------------------------------------------------mm-----------------------------------------------------------------h--
--------------------------------------------------------------------------------------h--------------Bmm------------------------m---mm-mm-m------------------------------------------------------------BBB-
------------------------------------------------------------------------------------BBBB-------mm----mmVmm---------------------mmm--m-##Vm-m---------------------------------------------------------------
----------------------------------------------------------------------------------------------mm-mm--m-[]-m--------------------mY-mm--##[]--m--------------------------------------------------------------
---------------------------------------------------------------------------------------------mm----mm--pP--m-------------------my###--##pP---m-------------------------------------------------------BB----
-----------------------------h--------------------------------------------------------h------m-----[]--pP---m-----------------m#####--##pP----m--------------------------------------------------------BBB-
---------------------------BBBB--------mm----BB#--mm-------mm--????---mmm-----------BBBBBB--m------pP--pP----m-------------mmm######--##pP-----m---------------mmmm----------------mmmm-----------mmm------
---------------------mmm--------mmm---mC-m-------mC-m-----mC-m-------m[]-m----mmm----------mC------pP--pP-----m---mmmm----m#########--##pP------mm-m-----------m[]-m----------mm--m[]#-m---------m[]-m-----
---------------------mC-m-------mC-m--mc--m------mc--m----mc--m------mpP--m---mC-m---------m#------pP--pP------m--m[]-m--m##########--##pP------#-m-mmmmmmmmmmm-pP--mmmmmmmmmmh-mmmpP#--mmmmmmmmmmpP--mmmmm
--mmmmmmmmmmmmmmmmmmm-c--mmmmmmm-c--mmmC---mmmmmmmc---mmmmmc---mmmmmmmpP---mmm-c--mmmmmmmmmmC########--pP-------mm-pP--mm#-#########--#####################################################################
################################-############################################################----------######################------------------------------------------------------------------------------
