-----------------------------------------------?k----#---#####--###############################################################----------------------------------------------------------------------------
---------------------------------------------############--------------------------------------------------------------------------------------------------------------------------------------------------
-----------------------------------------------------------------------------------------------------------------------------------------------------------------------------------------------------------
-------------------------------------------------------------------------------------------------------------------------------m---------------------------------------------------------------------------
-------------------------------------------------------------------------------------------m------------------------------------m--------------------------------------------------------------------------
-----------------------------------------------------------------------------------------mm-m---------------------------------m--m---------------------------------------------------M---------------------
----------------------------------------------------------------------------------------m##--m-------------------------------m#---m------------------------------------------------------------------------
-------------------------------------------------------------------mm------------------m###---m-----------------------------m##----m-----------------------------------------------------------------------
-----------------------------------------mmmm-------------------m-mm-mm---------------m####----m---------------------------m###-----m---------mmm----------------------------------------------------------
------------------------------mm--------mm[]-m-----------------mmmm-##-m-------------m#####-----m-------------------------m####------m-------mm[]mm----?M??????????------------------?---------------------
----------------------mmm----mC-m-----K-m-pP--m----------------m-#--##+Bm-----------m######?-----m-----------------------m#####-------m-----mm-pP--m-------------------------------------------------------
----------------------mC-m---mc--m-----mC-pP-----------------mm--#--##--Bm--------mm#######-------m---m-----m------mm---m######--------mm-m-m--pP---m----------------------------------------------mm------
--mmmmmmmmmmmmmmmmmmmm-c--mmmmc---mmmmmmc-pP---mmmmmmmmmmmmmm##--#--##----mmmmmmmm#########--------mmm-mmmmm-mmmmmm#-mmm#######--------#-m-m---pP----mmmmmmmmmmmmmmmmmmmmmmmmmmmmmmmmmmmmmmmmmmmmmmh-mmmmmm
############################################----##-#-##-###-#-#--#--##-----#-#-#-##########--------#-#---#-#--#-#-#--#-########-###########################################################################
