-----------------------------------------------------------------------------------------------------------------------------------------------------------------------------------------------------------
-----------------------------------------------------------------------------------------------------------------------------------------------------------------------------------------------------------
-----------------------------------------------------------------------------------------------------------------------------------------------------------------------------------------------------------
-----------------------------------------------------------------------------------------------------------------------------------------------------------------------------------------------------------
-----------------------------------------------------------------------------------------------------------------------------------------------------------------------------------------------------------
-----------------------------------------------------------------------------------------------------------------------------------------------------------------------------------------------------------
------------------mm---------------------------------------------------------------------------------------------------------------------------------------------------------------------------------------
-----------------mm-mm-------------------------------------------------------------------------------------------------------------------------------------------------------------------------------------
----------------mm----m----------------------------------------------------------------mm------------------------------------------------------------------------------------------------------------------
----------------m------m--BMB------------mm-----?--------------mm------??---mm--------mm-mmm-----------------mmm----------------------------------------mm-------------------------------------------------
--------------mm------C-m----------K----mC-m-------mmm--------mC-m---------mC-m------mm----Vmm--------------m[]-m---mmm---mmm--------------------------mC-m----mmm-----------------------------------mm---m
--------------mC------c--m--------------mc--m------mC-m-------mc--m--------mc--m-----mC----[]-m------mm-----mpP--m--mC-m--mC-m-----K-------mm----------mc--m---mC-m-----Kmm------------mm-----------mC-m--m
--mmmmmmmmmmmm-c------c---mmmmmmmmmmmmmmm#---mmmmmm-C--mmmmmmmmC---mmmmmmmmmc---mmmmm-c----pP--mmmmmmh-mmmmmmpP---mm-c--mm-c--mmmmmmmmmmmmmh-mmmmmmmmmmmc---mmm-c--mmmmmmh-mmmmmmmmmmmmh-mmmmmmmmmmmmc--mm-
##########################################################################################################################################################################################################-
