-----------------------------------------------------------------------------------------------------------------------------------------------------------------------------------------------------------
-----------------------------------------------------------------------------------------------------------------------------------------------------------------------------------------------------------
-----------------------------------------------------------------------------------------------------------------------------------------------------------------------------------------------------------
--------------------------------------------------------------------------------------------------------------------------------------------------------------------------------------------------mmmmm----
-------------------------------------------------------------------------------------------------------------------------------------------------------------------------------------------------mg##--m---
------------------------------------------------------------------BBBBBM?-----------------------------------------------------------------------BBBBBBBM??MM---------mm--------------------------m###?--m--
---------------------------------------------------------------------------------------------------------------------------------------------------------------------m-mm-----------------------m####----m-
-----------------------------------------------------------mm-------------------------------------------------------------------------------------------------------m----mmm-------------------m#####-----m
-------------------------------mm-----------h-h------mm----m-m----------------------------------------------------------------------------m?--------h--------------mm----[]-m-----------------m######------
------------------------------mm-mmmmm---?BBBBBB----mm-mmmm---m--m----BBB-------------------------------------------m---------------------mm----BB*BBBBBBBBBBB-----mB----pP------------------m#######?-----
---------------mmm-----mm-----m----[]-m---?--------mm----[]----mmmmmm--------mmm------------mm----mmm--------------m#m--------m---------mm--m---------------------m------pP--m--------------m########------
---------------mC-m---mC-m---mC----pP--m-----------mC----pP----[]-[]-m------m[]-m-----mm---mC-m---m#-m-------------m#-m-----mm-mm-------m#---m-------------------m#----B-pP---m------------m#########------
--mmmmmmmmmmmmm-c--mmmmC--mmmmC----pP---mmmmmmmmmmm-c----pP-k--pP-pP--mmmmmmmpP--mmmmmh-mmmmC--mmm-#--mmmmmmmmmmmmmm#--mmmmmgg-g-mmmmmmm-#----mmmmmmmmmmmmmmmmmmmm#------pP----mmmmmmmmmmmm##########------
###########################################################################################################################################################################################################
