----------------------#########-####---#####----###############----######---------------?#-----------------------------------------------------------------------------------------------------------------
--------------------------------------###########--------------------------------------m##-----------------------------------------------------------------------------------------------------------------
--------------------------------------------------------------------------------------m###-----------------------------------------------------------------------------------------------------------------
-------------------------------------------------------------------------------------m####-----------------------------------------------------------------------------------------------------------------
------------------------------------------------o-----------------------------------m#####--------------------#-------------------------------------------------------------------------------o------------
---------------------BB------------------------mm----------------------------------m######--------------####--####---------------------------------------------------BBB--------------------MBBBBM??-------
--------------------BB-B----------------------mm-mmm------------------------------m#######--------######---------------------------------------------------------------------mm----------------------------
---------------------------------------------mm-----m----------------------------m########-#######---------------------------------------------------------------------------mgmm--------------------------
---------------------------------------------m-------m-------------------mmmmmmmm##########-------------------------------------------------------------------mm-------------mg--m-------------------------
---------------------mm---------------------m---------m-----mmmmm-------m################--------------------mm----mm-------mm----------mm-----mm------------mm-mmm---------m###-----??M??-?--??BBBB-------
-------------mmm----mC-m------mm-----------m#-------##-mmm-m####-mm----m###----------------m------------mm---m-m---m-m-----mm-m---mm---mm-m---mm-m----------mm-----m-------m####--m----?---------------K--K
-------------mC-m---mC--m----mm#m--mmm----m##------######-m####--#-m--m###------------------m--m--m--m--m-m-----m-----m----m---m--m-m--m---m--m---m----m--m-m-------m----Km#####-------------mm-----------m
--mmmmmmmmmmm-c--mmmmc---mmmm#-#-mm##-mmmm###------############--#--mm####---------------mm--mm-mm-mm-mm---mm----mm----mmmm-----mm---mm-----mm-----mmmm-mm-m---------mmmmm######---mmmmmmmmmmC-mmmmmmmmmmmm
########################--#-#--#--#-#--######-----#############--#---#####---------------##---#--#--#--#----#-----#-----#-#------#----#------#------#-#-###################################################
