-------------------------------------------------------------------------------------#####-#-###-########################----------------------------------------------------------------------------------
-------------------------------------------------------------------------------------------#-####----------------------------------------------------------------------------------------------------------
-----------------------------------------------------------------------------------------------------------------------------------------------------------------------------------------------------------
-----------------------------------------------------------------------------------------------------------------------------------------------------------------------------------------------------------
-------------------------------------------------------------------------------------------------m-----------------------mm----------------------------------------------------h---------------------------
---------------------------------------------------------------------------B-----BBB--------------m--------------------mm--m-----------------------mm---------------M------?BBB?MM-------------------------
---------------------------------------------mmm------------------------------------BB---------mm--m------------------m##?--m---------------------mm-mmm-----------------------------------------V---------
--------------------------------------------m#B-m--------------------------------------------mm##---m----------------m###----m-------------------mm-----mm---------------------------------------[]--------
--------------mmmmmmmmmmmmm-o--------------m##---m---------mmm--+#---------------------------m###----m--------------m####-----m-----------mmmmm--m-----[]-m--------------------------------------pP--------
-------------m############-m---???MMM-----m###----m-------mm[]mm-?????M???--------mm-------mm-###-----m------------m#####------m----------m???-mm------pP--m----------M?M?----------?---mmm-----BB?BBB??---
------------m#############--m---?M-------m####-----m-----mm-pP--m----?----mmmm---mm-m------m#-###------m----------m######-------m------mmm-----[]------pP---m--------------------------mm#-m---------------
-----------m##############---m----------m#####------mm-m-m--pP---m--------m[]-m--m---m----m-#-###-------m---m----m#######--------mm-m--m[]-----pP------pP----m-------------------------m-#--m--mmm--------m
--mmmmmmmmm###############----mmmmmmmmmm######------#-m-m---pP----mmmmmmmm-pP--mm-----mmmm#-#-###--------mmm-mmmm########--------#-m-mm-pP-----pP------pP-----mmmmmmmmmmmmmmmmmmmmmmmmm--#---mmtg-mmmmmmmm#
##########################--#####################################################-----##-##-#-###--------#-#--#-#########-#############################################################--#################-
