--------------------------------------------------------------pP----pP---pP----#------pP------#####---###########------------------------------------[]--pP----------------------------------------------##
--------------------------------------------------------------c-----pP---########-----pP-----######---######################################---------pP--pP------------------------------------------------
--------------------------------------------------------------########--------##########################---------------------------------------------pP--pP------------------------------------------------
----------------------------------------------------------------------------------------------------------------------------------------------#########--###############-----------------------------------
-----------------------------------------------------------------------------------------------------------------------------------------------------------------------------------------------------------
-----------------------BBBBh--------------------------------------------------------------------------mmmmmm------m----------------------------------------------------------------------------------------
----------------------M--------------------------------------------------B---------------------------mm-----m---mm-m---------------------------------------------------------------------------------------
------------------------------------------------------------------------B-BBBBB---------------------mm-------m-m##--m--------------------------------------------------------------------------------------
-------------------------------------------------mm---------m----------BB------------------mm-------m---------m###---m------------------------mm-----------------------------------------mm----------mm----
-----------------------mm-????---------mm-------mm-m-------mmm---mm----mmm----------------mm-mmm---m----------####----m----------------------mm-mmm------mm------mm---------------------mm-mmmm------m-m---
--------------mmm-----mC-------mmm----mC-m------m---m-----mC--m-mm-mm--m--mmmmm----------mm-----m-m#---------#####?----m--------------------mm-----m----mmVmm---mm-mmm--------mm-------mm----B-m--mmm---m--
--------------mC-m----mc-m-----mC-m---mc--m----mC----m----mc---mm----mm---[]??-m------m--m-------m##-------#######------m--------------m----m-------m---m-[]-m--m-----m--m----m-m------m--------m-m[]----m-
--mmmmmmmmmmmm-c--mmmmmC--mmmmm-c--mmmmC---mmmmmC-----mmmmm#---C-----[]---pP----mmmmmm-mm--------###------########-------mmmmmmmmmmmmmm-mmmm---------mmm--pP--mm-------mm-mmmm---mmmmmm----------m-pP-----m
###################################################--########--c-----pP---pP-----#-#-#-[]------g####----##########--------#-#-#-#-#-#-#--#-#----------##--pP---#--------#--#-#----########-------####------
