------------------------------------------------------------------------------------------------------------------------------------------------------------#######----------------------------------------
-----------------------------------------------------------------------------------------------------------------------------------------------------------------------------------------------------------
-----------------------------------------------------------------------------------------------------------------------------------------------------------------------------------------------------------
-----------------------------------------------------------------------------------------------------------------------------------------------------------------------------------------------------------
-----------------------------BB----------------------------------------------------------------------------------------------------------------------------------------------------------------------------
----------------------------B--------------------------------------------------------------------------------------------------------------------------BB------------------------------------------------mm
--------------------------------------------------------------------------------------------------------------------------------------------------------BB----------------------mm-----------------------m-
-----------------------------------------------------------mmm-----------------------------------------------------------------------------------------------------mm----------mm-mmm--------------mm--mm--
------------------------------BBB-------------------------mm[]mm---------------------------------mmm--------------------------mmm-----------------BB--mm----------m#-m--------mm-----m------------mm-mm-#--
-------??-------------------mm-------Kmm------------mm---mm-pP--m------???????????--------------m[]-m------------------------m[]-m---------mmm-------mm-m--------m##--m-------m-------m----------mm--------
---------------mmm---mm----m#-m------m#-m----K-----m#-m--m--pP---mmm---------------------mm-----mpP--m---mmm---------mm------mpP--m--------mC-m------m---m---#--m###---mmmmmmm---------m---------m---------
---------------mC-m-mC-m---m#--mmmmmmm#--mmmmmmmmmmm#--mm---pP---gg-mmmmmmmmmmmmmmmmmmmmmh-mmmmmmpP---mmmgg-mmmmmmmmmh-mmmmmmmpP---mmmmmmmm-c--mmmmmm-----m----m####---##########-------mmmmmmmmm----------
--mmmmmmmmmmmmm-c--mmC--mmmmC########################################################################################################################------mmmm#####-------------------##############------
#############################-------------------------------------------------------------------------------------------------------------------------------#-######---------------------------------------
