------------------------------------------------#################################################----------------------------------------------------------------------------------#############----------V
-----------------------------------------------------------------------------------------------------------------------------------------------------------------------------------#############----------[
-----------------------------------------------------------------------------------------------------------------------------------------------------------------------------------#############----------p
-----------------------------------------------------------------------------------------------------------------------------------------------------------------------------###--#########################
---------------------------------------mm---BBBB-------------------------------------------------------------------------------------mm--------------------------------------------------------------------
--------------------------------------mmmm-------------m---------------------------------------------------------------------------m-m-m-------------------------------------------------------------------
-------------------------------------mm---mm-mm---------m-------------------------------------------------------------------------mgm---m------------------------------------------------------------------
-------------------------------------mC-----mm-m------m--m------------------------------------------------------------------------mg#----m-----------------------------------------------------------------
------------------------------------m-?-----C---m----m#---m-----------------------------------------------------------------------m##-----m--------------------mm----------m-----------------------mm------
----------?------------------------mC-------pP---m--m##----m------------------mmmmmmmmmmmmmmmmmmmmm------------------------------m###------m------------------mm-mmm-------mm-------B-------------mm-mmm---
------------------mmm-----mmm---K--m#-------pP----mm###-----m----------------m####################-m--------------------mmm-----m####-------m--------mmmm----mmY----m----mm--m---mm--------------mm-----m--
------------------mC-m--K-mC-m-----m#-------c -----####------m----m----mmm--m#####################--m-------mm----------m#-m---m#####--------mm-m----m[]-m---m-y-----m---m#---m--m-m-------------m-------m-
--mmmmmmmmmmmmmmmm-c--mmmm-c--mmmmmmC#########----#####-------mmmm-mmmm##-mm######################---mmmmmmmh-mmmmmmmmmm-#--mmm######--------#-m-mmmm-pP--mmm--#------mmm-#----mm---mmmmmmmmmmmmm---------m
#####################################-----------#######--------#-#--#-#-#--#####################################################################################-------#####----#---#############B---------
