---------------#######################---------------------------------------------------------------------------------------------------------------------------------------------------------------------
-----------------------------------------------------------------------------------------------------------------------------------------------------------------------------------------------------------
-----------------------------------------------------------------------------------------------------------------------------------------------------------------------------------------------------------
-------------------------------------------------------------------------------------------mmm-------------------------------------------------------------------------------------------------------------
--------------------------------------------------------------mm--------------------------mm#-m------------------------------------------------------------------------------------------------------------
----------------*---m--------------------------------------mmm#-m----------------------m-mm----m-------mm---------------------------------MBBBBB?BBBBBBB-mm------------------------------------------------
----------------*-mm-m--------------------------------------g##--m--------------------m--m------m-----mm-mmm--------------------------------------------mm-mm----------------------------------------------
----------------mm##--m------------------mm----------------m###---m-------------------mgm--------m---mm-----m-------------------------------------------m----m---------------------------------------------
---------------mm###B--m--------------?-mm-mmm------------m####----m------------------mg#---------m--m-------m-------------------------------mmmmmmmmmmm---------------------------------------------------
---------------m?###+---m--------------mm-----m----------m#####-----m----------------m###----------mm---------mmm--??M??-------------------mm??????????B------mm-------------------------------------------
-------------mm--###-----m-------------m-------mm-------m######------m--------------m####----------[]---------[]-m---------------mmm------m[]-----------------C-m-------mmm-------mm--------mmm-----K-----m
-------------m#--###------m-----m----mm--------#-------m#######-------mm-m---------m#####----------pP---------pP--m--------------mC-m-----mpP-----------------c--m------mC-m-----mC-m-------mC-m---------m#
--mmmmmmmmmmm-#-k###-------mmmmm-mmmm##--------#-mmmmmm########-------#-m-mmmmmmmmm######----#-----pP---k-----pP---mmmmmmmmmmmmmm-c--mmmmmmpP-----------------c---mmmmmm-c--mmmmmmC--mmmmmmm-c--mmmmmmmmmm#
####################-------#-#-#--#-#-#--------##############################################-#############################################################################################################
