---------------------------------##-#-?#--#--#################--#####---######-------------------------------------------------------------------------------------------------------------------##########
------------------------------------#-#---#----------------------------##############----------------------------------------------------------------------------------m--------------------------#########
--------------------------------------------------------------------------------------------------------------------------------------------------------------------mmm-m--------------------------########
--------------------------------------------------------------------------------------------------------------------------------------------------m----------------m###--m----------------------mmm-#######
-------------------------------------------------------------------------------------------------------------------------------------------------m-m--------------m####---m------------------Kmm###m-######
----------------------B???----------------------------------------------------------------------------------------------------------------------m#--m------------m#####----m------------------m#####m-#####
--------------------------------BBBB-----------------------------------------------------------------------------------------------------------m##---m-----------m#####-----m---------------mm-######m-####
----------------------------------------------------------------------------------------------------------------------------------------------m###----m---------m######------m--------------m#-#######m-###
-----------------mmm----------------------------------------------------------mm-------------mm---------mm------------mmmm-------------------m####-----m-------m#######-------m-----------mm-#-########m-##
----------------mm[]mm-????----mm--------------------------mmmmm-------------m#-m------------m-m------m-m-m-------mm--m[]-m--------mm-------m#####------mm-m--m########--------mm-m-mm-m-m##-#-#########m-#
---------------mm-pP--m----??-mm-m-------mm-mmmm----------m####-m-----------m##--m----mm---mm---m---mm-m---mmmmmmmk-mm-pP--mmmmmmmmh-mmmmmmm######------#-m-mm#########--------#-m-m#-m-m#-#---##########m-
---------------m--pP---m------m---m------mmmmm#-m--mmmmmmm#####--m--mmm----m###---m--mm-m--m#----m--m#-###########################################-#########################################-#-###########m
--mmmmmmmmmmmmm---pP----mmmmmm-----mmmmmm--#--#--mm############---mm##-mmmm####----mmm---mm-------mm-----------------------------------------------------------------------------------------#-############
##############################-----#-#-##--#--#-k-#-###########----#-#--#######-----#-----#--------#-------------------------------------------------------------------------------------------############
