-----------------------------------------------------------------------------?####--------------------------[]---------------#----------------------#--#######################--------------------------###
---------------------------------------------------???M---------------------m#####--------------------------pP----------------#######################------------------------------------------------------
-------------------------------------------mm------------------------------m######---------------------#----pP---------------------------------------------------------------------------------------------
----------------------------mmmm----------m#-m----------------------------m#######--------------------------pP-------------[]------------------------------------------------------------------------------
--------------------------mm--B-m--------m##--m-------h------------------m########-------------------------############----pP--------------------------------------m---------------------------------------
----------------mm-------mmB-----m------m###---???M??B?M----------------m###############-------------mm---#----------------pP#----------------------------------mmm-m--------------------------------------
---------------m#-m-----mm--------m----m####---m---K------------Kmm----m######----------------------mm-m------------------#pP----------------------------------m###--m-------------------------------------
--------------m##--m----m----------m--m#####-------------------Km#-m--m###--------------------------m---m-----------------------------------------------------m####---m------------------------------------
-------------m####--mmmm------------mm######----mmmmmmmmmmmmmmmmm#--mm##------------------#------mmm-----m---------------------------------------------------m#####----m--------mm----------------mm-------
------------m####-#######-----------####################################------------------------mm[]------m-------------------------------------------------m######-----m------mm-mmm-----mm-----mm-mmm----
-----------m#####---------------------------------------------------------------mmmmmm---------mm-pP-------m-----mm-----mm---------------------------------m#######------m----mm-----m---mm-m---mm-----m---
----------m######--------------------------------------------------------------m###??-m--m-----m--pP--------m--mmm-mmm--m-m-------m------m----------m-m--mm########-------m---m-------m--m---m--m-------m--
--mmmmmmmm#######-------------------------------------------------------------m####----mm-mmmmm---pP---------mmmm-----mm---mmmmmmm-mmmmmm-mmmmmmmmmm-m-mm##########--------mmm---------mm-----mm---------mm
##################------------------------------------------------------------#####?----#--#########----------#--------#-----#-#-#--#-#-#--#-#-#-#-#-#--#-#########--------#-#----------#------#-----##---#
