----------------------------------------------------------------------------------------------------#------------------------------------------------------------------------------------------------------
---------------------------------------------------------------------------------------------------#-------------------------------------------------------------------------------------------------------
-----------------------------------------------------------------------------------------------------------------------------------------------------------------------------------------------------------
------------------------------------------------------------------------------------------------------m---------------------------m------------------------------------------------------------------------
---------------------------------------------------------hh----h-------------------------------------m-m------------------------mm-m-----------------------------------------------------------------------
-------------------------------------------------------BBBBBBBB------------------------------------mm#--m----------------------m##--m----------------------------------------------------------------------
-------------------------------m-----------------------------------M-------------------------------m##---m--------------------m###---m---------------------------------------------------------------------
------------------------------mmm-----------------------------------------------------------------m-##----m------------------m####----m--------------------------------------------------------------------
-----------------------------mC--m----B-----------------h-h--h----------------------------------mmm-##-----m----------------m#####-----m-------------m-----------------------------------------------------
-----------------------------mc---m----B???????---mmm--BBBBBBBBBB--mm---------------------------mm#-##------m--------------m######------m------------mmm---------------------------------------------------
-----------------------------m#----mmm-----------mmO-m------------m#-m--mmm--------------------m----##-------m------------m#######-------m---------mm-?-m--------------------------------------------------
----------------------------m##----[]-m---------mm#---m-----------m#--m-m#-m------------mm----m#----##--------mm-m-------m########--------mm-m-----m#----m------------mm---------mm------mm----mm----------
--mmmmmmmmmmmmmmmmmmmmmmmmmm###----pP--mmmmmmmmmh-#----mmmmmmmmmmmm#---m-#--mmmmmmmmmmmm#-mmmmm#----##--------#-m-mmmmmmm#########--------#-m-mmmmm-#---#-mmmmmmmmmmmmk-mmmmmmmmmk-mmmmmmk-mmmmk-mmmmmmmmmm
#################################################################################################---#-###################################################-#################################################
