-----------------------------------------------------------------------------------------------------------------------------------------------------------------------------------------------------------
-----------------------------------------------------------------------------------------------------------------------------------------------------------------------------------------------------------
-----------------------------------------------------------------------------------------------------------------------------------------------------------------------------------------------------------
-----------------------------------------------------------------------------------------------------------------------------------------------------------------------------------------------------------
-----------------------------------------------------------------------------------------------------------------------------------------------------------------------------------------------------------
--------------------BB?--------------------------------------------------------------------------------------------------------------------------------------------------------BBBBBBBBBBBBBBBBB-----------
------------------------------------------------------------------------------------------------------------------------------------------------------M----------------------------------------------------
------------------------------------------------------------------------------------------------------------------------------------------------------K-----------------------------------------------mm---
--------------mmm--o----------------------------------------------------------------K-----------------------------------------------------------------------------------mmm--------hhhh--h-----------mm-m--
-------------mm[]mm-B????-----------------------------------------------------------------------------------------------------------------------------mm---------------mm##mm----BBBBBBBBBBBBBBBB----m---m-
------------mm-pP--m-----------------------------------------mmmm------------------mmm---------mm----------------------------------------------------m#-m-------------mm-##--m--------------------mmm-----m
------------m--pP---m-mm-----mm-----------mm-----------------m[]-m----mm-----------m#-mm------m#-m--------------K--Km----mm--------------------------m#--m------------m--##---m------------------mmm#------
--mmmmmmmmmm---pP----mk-mmmmmh-mmmmmmmmmmmh-mmmmmmmmmmmmmmmmm-pP--mmmmh-mmmmmmmmmmm-#-k-mmmmmmm#--mmmmmmmmmmmmmmmmmm-mmmmk-mmmmmmmmmmmmmmmmmmmmmmmmmmm#---mmmmmmmmmmmm---##----mmmmmmmmmmmmmmmmmmm--#----##
##################################################################################################################################################################################################---------
