-----------------------------------------------------------------------------------------------------------------------------------------------------------------------------------------------------------
-----------------------------------------------------------------------------------------------------------------------------------------------------------------------------------------------------------
-----------------------------------------------------------------------------------------------------------------------------------------------------------------------------------------------------------
-----------------------------------------------------------------------------------------------------------------------------------------------------------------------------------------------------------
-----------------------------------------------------------------------------------------------------------------------------------------------------------------------------------------------------------
-----------------------------------------------------------------------------------------------------------------------------------------------------------------------------------------------------------
-----------------------------------------------------------------------------------------------------------------------------------------------------------------------------------------------------------
----------------------------------------------------------------------------------------------------------------------------------------------------------------mm-----------------------------------------
---------------------------------------------------------------------------------------------------Chh---------------------------------------------------------mm-mmm--------------------------------------
----------?---------mmm-----------------?BB?B--mm--------mm---------??MBB---mm---------?---mm----BBBBBBB--------mm------???---Kmm-------------mm---------------m-----mm------------------------------------
-------------mmm---m[]-m---Kmmm---Kmmm--------mC-m------mC-m----mmm---?----mC-m------K----mC-m----------mmm----mC-m-----------mC-m-----------mC-m-----mmm-----mm-----C-m-----mmm------------------------mm-
-------------mC-m--mc --m---mC-m---mC-mK------mc--m-----mc--m---mC-m-------mc--m----------mc--m---------mC-m---mc--m----------mc--m----------m#--m----mC-m--K-mC-----c--m----mC-m--------mm------mm---KmC-m
--mmmmmmmmmmm-c--mmmpP---mmm-c--mmm-C--mmmmmmmmC---mmmmmmC---mmm-c--mmmmmmmmC---mmmmmmmmmmmc---mmmmmmmmm-c--mmmmC---mmmmmmmmmmmc---mmmmmmmmmmm#---mmmm-c--mmmm-c-----c---mmmm-c--mmmmmmmmh-mmmmmmh-mmmmmC--
###########################################################################################################################################################################################################
