---------------------------------------------------------------------------------------------------------------------------------------------------------#####------------------------?--------------------
-------------------------------------------------------------------------------------------###------------------------------------------------------------####---------------------------------------------
----------------------------------------------------------------------------------------------------------------------------------------------------------####---------------------mmm---------------------
---------------------------------------------------------------------------------------------------------------------------------------------------------#------------------------m###---------------------
---------------------------------------------------------------------------------------------------------------------------------------------------------------------------------m####---------------------
---------------------------MBB-----------B-------------------------------------------------------------------------------------------------------------------------------------mm#####---------------------
------------------------------B-------------------------------------------------------------------------------------------------------------------------#----------------------m######---------------------
---------------------------------------------------------------------------------------------------mmm------------------------------------------------m---------------------mmm-######---------------------
-------------------------------------mm-----mm-------------------------------------------m--------mBB-m-----------------------------------------------mmmm------------------mK#-######-----------------mm--
----------------------------mm--B??-mm-mmm-mm-mmm----------------------------------------mm-------m----m-----------mmm-------------mm----------------m-#m-----------------mm--#-######-#--m-----------mm-mm
-------------------mmm-----mC-m---Kmm----Vmm--[]-m-----------mm------------------------mm--m-----mm-----m----------K#-m-----------m#-m--------------m#--#-m---mm-----m---m##--#-######-----m---------mm----
-------------------mC-m----mc--m---mC----[]---pP--m---------m#-m----mm-----------------m#---m----m#------mmmmmmmmmmm#--mmmmmmmmmmmm#--mmmmmmmmmmmmmmm#-----m-m#-m--mm-mmm#-#--#-######--##--m--------m-----
--mmmmmmmmmmmmmmmmm-c--mmmmmC---mmm-c----pP---pP---mmmmmmmmmm#--mmmmm-mmmmmmmmmmmmmmmmm-#----mmmm-----################################################------m##--mm#########----#######------mmmmmmmm------
##########################################################################################----#-#------------------------------------------------------#----###---#-----------#--------#-----############--
