-----------------------------------------------------------------------------------------------------------------------------------------------------------------------------------------------------------
-----------------------------------------------------------------------------------------------------------------------------------------------------------------------------------------------------------
-----------------------------------------------------------------------------------------------------------------------------------------------------------------------------------------------------------
-----------------------------------------------------------------------------------------------------------------------------------------------------------------------------------------------------------
-----------------------------------------------------------------------------------------------------------------------------------------------------------------------------------------------------------
------------------------------------------------------------------------------------------------------------------------------------------------------------------------------------------------------BB---
----------------------------------------------------------------------------------------------------------------------------------------------------------------------------------------------------mm-----
---------------------------------------------------------------------------------------------------------------------------------------------------------------------------------------------------m#Bm----
-------------mmm-----------------------------------------------------------------m----------------------------------------------------------------------------------------------------------------m##--mmmm
------------mm[]mm---------------------------------------------------------------mmm------------------------------------------------------------------------------m------------------------------m#########
-----------mm-pP--m---------??????????-----------------------------------------mm-?-m----------------------mmm---------------mm----------------------------------m----------mm----------------mmm####------
-----------m--pP---mm-------------------------mmm-------mm---------------------m#----m----mmm-----------K--K#-m----mmm------m#-mm-------h---------mmm-----------m#-mm------m#-m--------------m#######------
--mmmmmmmmm---pP---k-mmmmmmmmmmmmmmmmmmmmmmmmmgg-mmmmmmmk-mmmmmmmmmmmmmmmmmmmmm-#-----mmmmgg-mmmmmmmmmmmmmmm#--mmmmm#-mmmmmmm#-k-mmmmmmmmmmmmmmmmmkk-mmmmmmmmmmmm#-k-mmmmmmm#--mmmmmmmmmmmmmmm#######------
#####################################################################################################################################################################################################------
