-------------------------------------------------------------------------------------------------------------------------------------------################################################################
-----------------------------------------------------------------------------------------------------------------------------------------##################################################################
--------------------------------------------------------------------------------------------------------------------------------------------###############################################################
-----------------------------------------------------------------------------------------------------------------------------------------mm----############################################################
---------------------------------------------------------------------------------------------------------------------h-------------------m-mmmm-###########################################################
-----------------------------------------------------------------------------------------------B---------------BBBBBBBBB---------------mm--####m-##########################################################
------------------------------------------------------------------------------------------------B------------------------------------m-m#--#####m-#pP######################################################
-------------------------------------------------------------------------------------------------------------------------------------mm----######m-########################################################
---------------------------------------------------------mm-----------------------------------------------mm----h-----------mmmmm--mm-#----#######m----####################################################
-------------------------mm---??-------mm---------------mm-mmm----------------mm--?????---------mm-------mm#mmBBBBBBBBBBB--mmY---m-m#------########mmmm-###################################################
--------------mmm-------mC-m----mmm---mC-m----K--------mm-----m--------------mC-m--------mmm---m#-m-----mm-#--m-----------mm-y----m-#------############m-##################################################
--------------mC-m------mc--m---mC-m-Kmc--m----mm--K---mC------m----mm-------mc--m-------mC-m--m#--m----m--#---m---h------m--B----####-----#############m--------------------------------------------------
--mmmmmmmmmmmm-c--mmmmmmmC---mmm-c--mmmc---mmmmh-mmmmmm-c-------mmmmh-mmmmmmmmc---mmmmmmm-c--mmm#---mmmm---#----mmmmmmmmmm------------#----##############mmmmmmmmmmmmmmmmmmmmmmmmmmmmmmmmmmmmmmmmmmmmmmmmmm
##########################################################################################################################-----------------################################################################
