-------------------------#####---###---------###--###--------------------------------------M----------------------------------#############################################################################
---------------------------------###---------###--###-------------------------------------------######-----------------------------------------------------------------------------------------------------
--------------------------------########-#-#####--###------------------------------------------------------------------------------------------------------------------------------------------------------
----------------------------------------#---####--##########------------------------------Y-----------------------------------------------------------------------------------m----------------------------
------------------------------------------------------------------------------------------y------------------------------------------------------------------------------------m-------------------------m-
----------------------------------------------------------------------------------------###-----------------------------B---------------------------------------------------mm--m----------------------mm-m
---------------------------------------------------------------#----####################-------------------------------*---------------------------------------------------m##---m--------------------m##--
-----------------mmmm---------------------------------m---------####---------------------------------------------------mm-------------mmm---------------mmm---------------m###----m------------------m###--
----------------m#BB-mo-----------B------mmm--------mm-m--------------------------------------------------------------mm-m-----------m#B-m-------------m#B-m-------------m####-----m----------------m####--
---------------m##----m--------mmm--------m-m-----mm##--m-----mm-------------------------mm---------------------------m?--mm--------m##---m-----------m##---m-----------m#####?-----m--------------m#####--
--------------m###-----m-------m?-m------m---mm--mm###---m---mm-m---mm---mm---mm---mm---mm-m---mm-----mm------------mm----Y-m------m###----m---------m###----m---------m######-------m------------m######--
-------------m####----B-m----mm----mmm--m#-----m-m-###----m--m---m--m-m--m-m--m-m--m-m--m---m--m-m--mmm-mmm---------m#----y--m----m####-----m----m--m####-----m----m--m#######--------m-------m--m#######--
--mmmmmmmmmmm#####-----B-mmmm##---###-mm##------m--###-----mm-----mm---mm---mm---mm---mm-----mm---mmmm-----mmmmmmmmm-#-k--#---mmmm#####------mmmm-mm#####------mmmm-mm########---------mmmmmmm-mm########--
##################--------#-#-#---###--#-------##--###------#------#----#----#----#----#------#----#--------#################--#-######-------#-#--######-------#-#--#########---------#-#-#-#--#########--
