--------------------------------------------------------------------------------------------------------------------------------------------------##--##---------###---------------------------------------
----------------------------------------------------------------------------------------------------------------------------------------------------------#------###-------------------####################
----------------------------------------------------------------------------------------------------------------------------------------------------------##-----###---------------------------------------
-----------------------------------------------------------------------------------------------------------------------------------------------------------------###---------------------------------------
-------------------------------------------------------------------------------------------------------------------------------------------------------------#---###---------------------------------------
-------------------------------------------------------mm---m---------------------------------------------------------------------------------------------------####---------------------------------------
------------------------------------------------------mm-mmm-m---------------------------------------------------------------------------------------BBBB--------#######-----------------------------------
-----------------------------------------------------mm----M--m---------------------------------------------------------------------------------mm-----B-B------------------------mm-----------------------
-----------------------------------------------------m---------m--------------------------------------------------------------------------mm----m-mmmm----B----------------------mm-m----------------------
--------------------------mm---?????----mm--?????---m-----------m---------------------------------------------mm-------------------------mm-mmmm---[]-m----------------------mm--m---m---------------------
------------------mmm----mC-m----------mC-m--------mC---------C--mm------------------------------mm----------mC-m------Kmmm------------Kmm----[]---pP--mmm-----------m------mm-mm-----m--------------------
------------------mC-m---mc--m---------mC--m-------mc---------c--C-m-----mm------mm----------h--mC-m---------mc--m------mC-m------------mC----pP---pP--[]-m----m--mmm-m--m--m---#------m-------------------
--mmmmmmmmmmmmmmmm-c--mmmmC---mmmmmmmmmmc---mmmmmmmmc---------c--c--mmmmmh-mmmmmmh-mmmmmmmmmmmmmmc--mmmmmmmmmmc---mmmmmm-c--mmmmmmmmmmmm-c----pP---pP--pP--mmmmmmm###--mm-mm------------mmmmmmmmmmmmmmmmmmm
#################################################################################################################################################### --pP---#-#--####---#--#-------------#-#-#-#-#-#-#-#-#-
