----------------------------------------------------------------------?-------######--------------------------##---------------------------------------##--------------------------------------------------
----------------------------------------------------------------------###############################---------------------------------------------------##-------------------------------------------------
-----------------------------------------------------------------------------------------------------------------------------------------------------------------------------------------------------------
-----------------------------------------------------------------------------------------------------------------------------------------------------------------------------------------------------------
--------------------------------------------------------------------------------------------------------------------------------------------------mm-------------------------------------------------------
-------------------------------------------------------------------------------------------------------------------------------------------------mm#m------------------------------------------------------
-------------------------------------------------------------------------------------------------------------------------------------------------m---mm----------------------------------------------------
------------------------------------------------------------------------------------------------------------------------------------------------m------m---------------------------------------mmm---------
----------------------------------------------------------------mmm-----------------mm----------------------------mm------------------------mmmmB-------m------mm-----------------------------mm[]mm-------
---------------------------------------------------------------mm[]mm?B------------m#-m--------------------------mm-m----------------------mm#BB---------mmm--mm-mmm-------------------------mm-pP--m------
--------------------------------------------------------mmm---mm-pP--m------------m##--m--------------------m----m---mmm------------------mm-#-----------k#-m-m-----m-------mm---------------m--pP---m-----
---------------------------------------------------mm--m[]-m--m--pP--------------m###---m---------------m----m--m-------m---------mm------m--#-----------#---m-------mmmmmmmk-mmmmmmmmmmmmmmm---pP----mmmmm
--mmmmmmmmmmmmmmmmmmmmmmmmmmmmmmmmmmmmmmmmmmmmmmmmmh-mmmpP--mm---pP---mmmmmmmmmmm####----mmmmmmmmmmmmmmm-mmm--mm#--------mmmmmmmmmk-mmmmmm-k-#--------#--#---#-----########################################
#####################################################################--##-#-#-#######-----##-#-#-#-#-#-#--##---#----------#####################--------#-#-------------------------------------------------
