--------------------################################-----B----------------########-------------------------------------------------------------------------------------------------------------------------
----------------------------------------------------------B-----##-----------------------------------------------------------------------------------------------------------------------------------------
-------------------------------------------------------------------------------------------------------------------------------------------------------------------------------------m---------------------
-------------------------------------------------------------------------------------mm---o----------------------------------------------------------------------------------------mm-m--------------------
------------------------------------------------------------------------------------mm-mo-m--------------------------------------------------------------------------------------mm##--m-------------------
-----------------------------------------------------------------------------------mm---mm-m------------------------------------------------------------------------------------mm###---m------------------
-----------------B-?------------mm-------------------------------------------------m-----M--m------V----------------------------------------------------------------------------m-###----m-----------------
--------------------B----------m#+m-----------------------------------------------m----------m-----[]--------------------------------------------------------------------------m--###-----m-----------mm---
------------------m-----------m##-----------------mmmmm--------------------------m#-----------m---BpP-------------------------------------------------------------------------m#--###------m---------mm-mmm
------------------mm---------m###--m-------------m###B-m--------------mm--------m##B-----------mmm-??M-??MB?-----------------------------------------------------------------m##--###-------m-------mm-----
----------------mm-?m-------m####---------------m####---m-----mm-----mm-m------m###------------[]-m-------------------------------------------------------------------------m###--###--------mm-m---m------
----------------m#---m-----m#####---m---------mm#####----m----m-m----m---m----m####------------pP--m-----mm---------mm-----------------------------------------------------m####--###--------#-m-mmm-------
--mmmmmmmmmmmmmm-#----mmmmm######----mmmmmmmmm#######-----mmmm---mmmm-----mmmm#####------------pP---mmmmmh-mmmmmmmmmh-mmmmmmmmmmmmmmmmmmmmmmmmmmmmmmmmmmmmmmmmmmmmmmmmmmmmm#####--#####################----
###################----##-#######----#-#-#-#-########----B-#-#----#-#------#-######--###########################################################################################---------------------------
