----------------------------------------#--------------------------------------------#-------------##########---------------------#----------------------------------------pP---------pP---------pP--##----
-------------------------------------##----------------------------------------------#--------#----------------------------------------------------------------------------pP---------pP---------pP--##----
----------------------------------------------------------------------------------------------------------------------------------mmm--------------------------------------########################--##----
-------------------------------------------------------------------------------------------------------------m-------------------m[]-----------------------------------------------------------------######
-------------------------hh-------------------------------------------------h---------------------------------m-----------------mmV--m----------------------------------#----------------------------------
------------------------BBBBBBM-------------------------------------------BBBBBM?M--------------------------m--m---------------mm#----m----------------------------------mm--------------------------------
-----------------------------------------------------------------------------------------------------------m#---m--------------m?-#----m---------------------------------m-m-------------------------------
-----------------------------------BBB--------------------------------------------------------------------m##----m------------m---------m-------mm-------------mm-----mmm------------------mm--------------
-------------------mm-----------------------mmm------------mmmmmmmmmmmmm---h----------O------------------m###-----m----------m#?---------m-----mm#m-----------mm-mmm--m##---mmm-----------mm-mmm-----------
------------------mm#mmBBBBBBBBB#----------mmB-mBBB-------m############-BBBBBBBBBBB-----------mmm-------m####------m--------m##-----------m---mm-#-mm---------m-----mm##----[]-m----mm---mm-----m----mm-m--
-----------------mm-#--m-----------mm-----mm----m--------m#############-m----------------mm---m#-mm----m#####-------m------m###---V--------m--m--#---m-----mmm------[]------pP--m--mm-m--m-------m--mm-m-m-
-----------------m--#---m--------mmm-m----m------m------m##############-------------mm-mmm-mmm-----m---######--------mm-m-m####---[]--------mm---#----m----m[]------pP------pP-----m---mm---------m-m-##--m
--mmmmmmmmmmmmmmm---#----mmmmmmmmmm---mmmm--------mmmmmm###############--mmmmmmmmmmmmmmmm----B------mmm######--------#-m-m#####---pP##############-----mmmm-pP------pP------pP---mm----[]---------Vm--##---
#################################------#-#------####################################--#-------------#-#######-######################-------------------#################----pP----#----pP---------[]--##---
