--------------------------------------------------------------------------------------------------------------B---------------------------------------------------#########################################
----------------------------------------------------------------------------------------------------------------------------------------------------------------##-----------------------------------------
-----------------------------------------------------------------------------------------------------------------------------------------------------------------------------------------------------------
-----------------------------------------------------------------------------------------------------------------------------------------------------------------------------------------------------------
---------------------------------------------------------------------------------------------------------------------------------------------------------------------------m-------------------------------
--------------------------------------------------------------------------------------------------------------------------------------------------------------------------m-m------------------------------
-------------------------------------------------------------------------------------------------------------------------------------------------------------------------m#--m-----------------------------
------------------------------------------------------------------------------------------------------------------------------------------------------------------------m##---m----------------------------
-------------------------------------m------------------------------------------------------------mmmmmmmmm----------mm-----------mmm--o-------------------------------m###----m---------------------------
---------------------mm--????-------m-m---------mm-------?????----mm-----------------------------m########Bmm-------mm-mmm-------mm[]mm-------------------------------m####-----m----------mmmm------------
--------------mmm---mC-m------------mC-m-------mC-m--------------mC-m------Kmmm--K----Kmm----Kmmm#########-B-m-----mm-----m-----mm-pP--m-----?M?---mm-------mmmm-----m#####------m--------mm[]-m-----------
--------------mC-m--mc--m--------K--mC--m------mc--m-------------mC--m------mC-m--m---m#-----m############----m----m-------m----m--pP---m----------m-m------m[]-m---m######-------m---m--mm-pP--m------mm--
--mmmmmmmmmmmm-c--mmmc---mmmmmmmmmmmmc---mmmmmmmc---mmmmmmmmmmmmmmc---mmmmmm-c--mmhmmmm#-mmmmm############-----mmmm---------mmmm---pP----mmmmmmmmmm---mmmmmm-pP--mmm#######--------mmm-mmm--pP---mmmmmm#-mm
###########################################################################################################---B-#######---#########################---#########---#########--------#-#------pP----#-#-#---#
