------------------------------------------------------------------------------------------------??#-----------#####--------#----pP-------------pP---------pP--V------------------------------#########---##
------------------------------------------------------------------------m-m----mm------mm------m#------#----##########################----##############--pP--[]--------------------##---------------------
----------------------------------------------------------------------mm-m-mmmmk-mmmmmmk-mmmmmmmpP--------------------------------------------------------pP--pP-------------------------------------------
----------------------------------------------------------------------m#-#-#######################--------------------------------------------------------pP--pP-------------------------------------------
----------------------BB--------------------------------------------mm----------------------------#-----------------------------------------------------------pP-------------------------------------------
----------------------[]BBOB????----------BBBBBBBBM-------BBBB------m#----------------------------------------------m----------------------------------------#########--------------------------------mm---
----------------------V-------------------------------------------mm-----------------------------------------------m-m--------------------------------------------------------------------------------m-m--
------------------------------------------------------------------m#----------------------------------------------m#--m------------------------------------------------------------------------------m---m-
--------------------mmm---------------------k-h--------mmmm-----mm-----------------------------------------------m##---m----------------------------------------------------------------------------m#----m
-------------------mm[]mm-????M??----------BBBBBBBBB----#O----mmm#----------------------------------------------m###----m-------mm-------------mmm---------------------mm-----------------mm-------m##-----
------------------mm-pP--m------------mmmm-------------m#--m-mm#-----------------------------------------------m####-----m-----mm-m-----------mm[]------mm--------mm---m-m---mm---mm-----mm-m-----m###-----
------------------m--pP---mmm----mm---m[]-mm----------m##----m----------------------------------------m----m--m#####------m----m-V-m-----m----m-pPmm----m-m----m--m-m-----m--m-m--m-m----m---m---m####-----
--mmmmmmmmmmmmmmmm---pP----k-mmmmg-mmm-pP-k-mmmmmmmmmmm##---m------------------------------------mmmmm-mmmm-mm######-------mmmm--[]-mmmmm-mmmm--pP--mmmm---mmmmmmm---mm----mm---mm---mmmm-----mmm#####--#--
#############################################################------------------------------------###-#--#-#--#######--------#-#--pP--##-#--#-#--pP---#-#---[]-#--#----#-----#----#----#-#-----#-######---#-
