-----------------------------------------------------------------------------------------------------------------------------------------------------------------------------------------------------------
-----------------------------------------------------------------------------------------------------------------------------------------------------------------------------------------------------------
-----------------------------------------------------------------------------------------------------------------------------------------------------------------------------------------------------------
-----------------------------------------------------------------------------------------------------------------------------------------------------------------------------------------------------------
-----------------------------------------------------------------------------------------------------------------------------------------------------------------------------------------------------------
-------------------------------------------------------BBBB----------------------------------------------------------------------------------------------------------------------------------------------BB
-----------------------M-----------------------------------B-------------------V----------------------------------------------M----------------------------------------?-----------------------------------
-----------------------------------------------------mm------------------------[]--------------------------------------------------------------------------------------------------------------------------
-----------------h--------------mm------------------m#?mh-----------------mmm--pP----------------------------------------------------------------m---------------------------------mm---------------mm-----
---------------BBBBB---mm------mm#mm---------------m##-?BBB---mm-------K-mm[]mm???M?------------------------mm----------------mm-----------------mm--------------------mm---------mm-mmmmmm--------mm#mmm--
-----------mmm-------Km#-m----mm-#--m---?????---mmm###--m----m?-m------Kmm-pP--m--------mmmmm--------------m#-m--------------m#-m--------------mm--m-------------K----m#-m-------mm-----[]-m------mm-#---m-
-----------mC-m-------m#--m---m--#---m-------??m######---m---m---m------m--pP------mm---m[]#-mm---mmm------m#--m-------------m#--m-------------m#---m-----------------m#--m------m------pP--m-----m--#----m
--mmmmmmmmm-c--mmmmmmmm#---mmm---#----mmmmmmmmmm-#####----mmmm----mmmmmm---pP---mmmk-mmm-pP#-k-mmmmB-mmmmmmmpP--mmmmmmmmmmmmmm#---mmmmmmmmmmmmm-k-k--mmmmmmmmmmmmmmmmmm#---mmmmmm-------pP---mmmmm---#-----
###########################################################################################################################################################################################################
