---------------------------------------------------------------pP--?----V-------pP-------pP--pP----------------##-------------------------------------------######-----------------------------------------
---------------------------------------------------------------pP-------[]------pP-------pP--pP----------------##------------------###########-------------#######-----------------------------------------
---------------------------------------------------------------pP-------pP------pP-------##--pP----------------##-----------------------------------------########-----------------------------------------
------------------------------------------------------------#-#pP-------pP------#####--------######-----------###----------------------------------------#########-----------------------------------------
--------------------------------------------------------------########--##-----------------------------------####----------------------------------------#########--------------------------------------Y--
--------------------------------------BM?O-------------------------------#####----------------------------#######-------------------------------##################-#####--------------------------------y--
------------------------------------?B--B----------------------------------------------------------------########-#######-------------------------------###########-----#########------------------######--
-----------------------------------------------------------------------------------------------------#############------####-----------------------------------------------------##################--------
------------------------mm---------------------mmm-------------------------------------------mm------------------------------------------------------------------------------------------------------------
-----------------------mC-m---??????--BBBBB----mB-m----------------------------mm------mm---mm-------------------------mm----------------------mm------mm----------m-----mm----------------------------mm--
---------mmm----mmm----mc--m-----------------mm----m---Kmmm----mmm-------------m-m----mm-mm-m-Vmm---mm---mm-------m---mm----------------------mm-m----mm-mmm---mmmm-m---mm-m---mm---------------------mm-mm
---------mC-m----C-m---mc---m----------mm--mmmC-----m--Kmmmm--mm[]m----m----m----Vmm--m---Vm--[]-m--m-m--m-mm------m--m--m--m-----m------m----m---mm--m-----m-mg###--m--m---m--mmm--m--m--m--m--m--m--m----
--mmmmmmm-c--mmmmC--mmmmC----mmmmmmmmmmh-mmmC-c------mmm----mmm-pP-mmmm-mmmm-mm--[]-mm----[]--pP--mm---mm----mmmmm--mm----mm-mmmmm-mmmmmm-mmmm------mm-------m#####---mm-----mm---mm-mm-mm-mm-mm-mm-mm-----
########################################################-----#--pP--#-#--#-#--#--pP--#----pP--pP---#----#------###---#-----#--##-#--#-#-#--#-#-------#-------######----#------#----#--#--#--#--#--#--#-----
