--------------------------------------------------------------------########-------------------------------------------------------------------------------------------------------------------------------
---------------------------------------------------------------------------------------------------------m-------------------------------------------------------------------------------------------------
-------------------------------------------------------------------------------------------------------mm-m------------------------------------------------------------------------------------------------
------------------------------------------------------------------------------------------------------m##--m-----------------------------------------------------------------------------------------------
-----------------------------------------------------------------------------m-----------------------m###---m------------------------------------------------------------------------------M---------------
---------------------------------------------------B------------------------m-m---------------------m####----m---------------------------------------------------------------------------------------------
--------------------------------------------------B------------------------m#--m-------------------m#####-----m----------------mm------------------------m-------------------------------------------------
------------------------mmm-----------------------M-----------------------m##---m-----------------m######------m-------K------mm-mmm--???????M?M???M-----mmmm------------------------------mm--------------
-----------------------m##-m---------------------------------------------m###----m---------------m#######-------m--------K---mm--[]-m------------------mm-?#-m----------------------------m#-m-------------
----------------------m###--m----------------------m------------mm------m####-----m-----mm-m----m########--------m-----------m---pP--m-----------------m#--#--m--------mm----K------------m#--m----mm----mm
---------------------m####---mm------------------mm-m----------mm-m----m#####------mmmmm#-m-mmmm#########---------mmmmmmmmmmm----pP---mmmmmmmmmmmmmmmmm-#--#---mmmmmmmmk-mmmmmmmmmmmmmmmmmm#---mmmmk-mmmmk-
--------------------m#####---B-m----m------------m#--m---------m---m--m######------#######################################################################-#--#############################################
--mmmmmmmmmmmmmmmmmm######------mmmm-mmmmmmmmmmmm-#---mmmmmmmmm-----mm######------------------------------------------------------------------------------##-----------------------------------------------
##########################------BB-#-##########################------########------------------------------------------------------------------------------------------------------------------------------
