-------------------------------------------------------------------------------------------###-------------------------------------------------------------------------------------------------------######
-----------------------------------------------------------------------------------------------------------------------------------------------------------------------------------------------------------
-----------------------------------------------------------------------------------------------------------------------------------------------------------------------------------------------------------
-----------------------------------------------------------------------------------------------------------------------------------------------------------------------------------------------------------
--------------------------------------------------------------------------------------------------------------------------------------------------------------------------------------------------------m--
--------------------------------------------------BBBBBBBBBBBB-------------------------B---------BBBBB??MM?-------BBBBBBBB?----BMB-------------------------------------------------------------------mmm-m-
-----------------------------------B----------------------------------------------------BBB----------------------B----------------------------------------------------------------------------------mm##--m
-------------------------------------------------------------------mmm---------------------B--------------------------------------------------------------------------------------------------------m-##---
-------------------------------------------------mm---------------mm[]-------------------------------------------mm-----------------------------------------------------------m----------------mmmmm--##---
------?M---------------------------mm-----------mm#mmBBBBBBBBBB---m-pPmm--????----------mm---------BBMBBB??-?---mm-mm----?-----?------?????-?-------------------------?M------mm--------------m#####--##---
---------------------------mmm----m#-m---------mm-#--m-----------m--pP--m-----???????--mm-m--------------------mm----m-------------------------------------------------------m--mm-----------m######--##---
--------------mm-----------m#-m---m#--m-------mm--#---m----------m--pP---m-------------m---m-------------------m------mmm-------------mmm--------mm---mm---------mm---------m#--#-m---------m#######--##---
--mmmmmmmmmmmm#-mmmmmmmmmmm-#--mmmm#---mmmmmmmm---#----mmmmmmmmmmm--pP----mmmmmmmmmmmmm-----mmmmmmmmmmmmmmmmmmm-------gg-mmmmmmmmmmmmmgg-mmmmmmmmk-mmmk-mmmmmmmmmk-mmmmmmmmmm#--#--mmmmmmmmm########--##---
#######################################################################################------##################-----###########################################################----#################--##---
