--------------------------------------------------------------------------------------------------------------------------##-------------------------------------------------------------------------------
-----------------------------------------------------------------------------------------------------------------------------------------------------------------------------------------------------------
-----------------------------------------------------------------------------------------------------------------------------------------------------------------------------------------------------------
-----------------------------------------------------------------------------------------------------------------------------------------------------------------------------------------------------------
-----------------------------------------------------------------------------------------------------------------------------------------------------------------------------------------------------------
-------------------------------------------------BBBBB????-------------------------------------------------------------------------------------------------------------------------------------------------
-----------------------------------------------------------------------------------------------------------------------------m-----------------------------------------------M-----------------------------
-----------------------------------------------------------------------------------------------------------------------------#-----------------------------------------------------------------------------
--------------------------m-------------mmm-------hh--h--------------------------------------------mmmmmmmmmmmmmmmmmmmmmmmm--------------------------------------------------------------------------------
--------------------------mm-----------mm[]mm----?B?BMBBB?----------------------------------------m########################m--m---???----------------------------------------mm----------------------------
-----------------mmm------m-m----------m-pP--m-------------------------------mm---------mmmmmmmmmm########################-#m----------mm------------------------mm---------m#-m---------------------------
-----------------mC-m----mC--m--------mC-pP---m--------mm-------------------m#-mm------m##################################--#m-m-------m-m--------mm--mm--------m#-m----mm--m#--m--mm---------------mm-----
--mmmmmmmmmmmmmmm-c--mmmmmc---mmmmmmmmmc-pP----mmmmmmmmh-mmmmmmmmmmmmmmmmmmmm#-#-mmmmmmm##################################------mmmmmmm---mmmmmmmmk-mmk-mmmmmmmmm#--mmmmk-mmm#---mmk-mmmmmmmmmmmmmmmk-mmmmm
###########################################################################################################################--##########---#################################################################
