----------------------------------------------------------------------------------------------------------------------------------------------------------------------------------------------------??#---#
---------------------------------------------------------------------------------------------------------------------------------------------------------------------------------------------------m#------
------------------------------------------------------------------------------------------------------------------------------------------------------------------m-------------------------------m##------
-------------------------------------------------------------------------------------------------------------------------------------------------------mm---------mm-----------------------------m###------
------------------------------------------------h------------------------------------------------------------------------------------------------------m-m------mm--mmmmmmmmmmmmmmmmmmmmmmmmmmmmm####------
-------------------------------------------BBBBBB*BBBBBB-------------------------------------------------------------------------------B-------------mm---m-----m#--#################################------
-------------------------------------------------------------------------------------------M---------------------------------------------------------m#----mmmmm-#--#################################------
---------------------------------------------------------------------------------------------------------------------------------------------------mm-----#########-###################################----
------------------------------mmm--------------h---------------------------------------------------------------------------------------------o-----m#--------------##################################------
-----------------------------mm[]m---------BBBBBBBBBBBBB-----------------------------------mm-----------------mmm---------------------mm---------mm--------------------------------------------------------
----------------------------mm-pP-m---mm-----------------------------------mmm------------m#-m---------------m[]-m------------mmm----mm-m---mm--mm#--------------------------------------------------------
----------------------------m--pP--m--m-m-------------------mmm------------m#----mm-------m#--m--mmm---------mpP--m------mm----#-m---m---m--m-m-m---------------------------------------------------------m
--mmmmmmmmmmmmmmmmmmmmmmmmmm---##---mm---mmmmmmmmmmmmmmmmmmmgg-mmmmmmmmmmmm-#-mmmk-mmmmmmmm#---mmkk-mmmmmmmmmmpP---mmmmmmg-mmmm#--mmm-----mm---m-----------------------------------------------------mmmmm-
######################################---############################################################################################------#---#-----------------------------------------------------##--#-
