------------------################-#######################################################################################################-----------------------------------------------------------------
-----------------------------------------------------------------------------------------------------------------------------------------------------------------------------------------------------------
-----------------------------------------------------------------------------------------------------------------------------------------------------------------------------------------------------------
----------------------------------------------------------------------------------------------------------------------------------------------------------------------------------------------------BBBB---
-------------------------------------------------mm----------------------------------------------------------------------------------------------------------------------------??M??BM??-------------------
------------------------------------------------mm-mooo----------------------------------------------------------------------------------------------------------------------------------------------------
-----------------------------------------------mm---mmm---M-----------------------------------------------------------mm-------------------m---#--------------------------------------------------mm-------
--------------------------------------------mm-m-------m-------------------------------------------------------------m#-m-----------------m-m-------------------------mmm------------------------mm-mmm----
------------------mmm----------------------mmgm---------mo--------------mm------------------------------------------m##--m---------------m#B-m-----------------------mm[]mm--???????M???M-------mm-----m---
------------------mm-----------------------m###----------m-------------m#-m-----------mmmmmmmmmmmmmmmmmmmmmm-------m###?--m-------------m##---m----------------------m-pP--m---?----------------m-------m--
----------------mm--#mm----------mm-------m####-----------mmm---------m##--m---------m#####################-m-----m####----m-----------m###----m-----mm-m-----------m--pP---m------------------m---------mm
----------------mC--#--m--------mm#mm----m#####-----------[]-m----m--m###---m----m--m######################--m--mm#####-----m----mm---m####-----mmmmm#-m-mmmmmmmmmmmm--pP----mmmmmmmmmmmmmmmmmm#---------##
--mmmmmmmmmmmmmm-#--#---mmmmmmmm#-#--mmmm######-----------pP--mmmm-mm####----mmmm-mm#######################---mm#######------mmmm#-mmm#####-----################################################-----------
###################k#----#-#-#-#--#---#-#######-----------pP---#-#--#####-----#-#--########################----########-------#-#--#-######----------------------------------------------------------------
