--------------------------------------------------------------------------------------------------------------------------------------------------------?-#################################################
------------------------o---------------------------------------------------------------------------------------------------------------------------mm-m---------------------------------------------------
---------------------------------------------------------------------------------------------------------------------------------------------------mm-m----------------------------------------------------
---------------------------------------------------------------------------------------------------m-------------------------------------------mm--m-------------------------------------------------------
-------------------###---------------------------------m---------------------------------------mmmm-m---------------------------------B-------mm-mm---------------------m----------------------------m-----
------------------m-----------------------------------m-m--------------------???????M---------m####--m---------------------------------------mm---M----------------mmmmm-m-----------------------mmmm-m----
------------------#----------------------------------m#--m-----------------------------------m#####---m-----------m-------------------mm-----m--------------------m#####--m---------------------m####--m---
----------------mm-m--------------------------------m##---m---------------------------------m######----m-----------mm----------------mm-mmm-------------#--------m######---m-------------------m#####---m--
---------------m##----------------------------------m##----m----------mmm--o?--h-----------m#######-----m----------m-mmm-------------m-----mm---?M----k##[]-----m#######----m-----------------m######----m-
--------------m###m-m------------------------------m###-----m--------mm[]mm--?????????----m########------m--------m-----m---mmmm--mmm------[]---------V### ----m########-----m---------------m#######-----m
-------------m###-?----mm-------------------------m####------m------mm-pP--m-------------m#########-------m------mm------m--m[]-m-m[]------pP---------####----m#########------m-------------m########------
------------m####----m-m-m-----------------------m#####-------mm-m--m--pP---m-----------m##########--------mm-m--mY-------mm-pP--m-pP------pP--------####----m##########-------m---m----m--m#########------
--mmmmmmmmmm#####-----m---mmmmmmmmmmmmmmmmmmmmmmm######-------#-m-mm---pP----mmmmmmmmmmm###########--------#-m-mm-y---###################################mmmm###########--------mmm-mmmm-mm##########------
##################----#----########################################################################################--------------------------------------#--############--------#-#--#-#--###########------
