------------------------------------------------?##-----------------------###########--#--##-------------###----------######-------------------------------------------------------------------------------
-----------------------------------------------m-##---------------------------------------##-------------###---------#######-------------------------------------------------------------------------------
-----------------------------------------------m###----------------------------------------#################--------------------#------------------------------------------------------BBBB----------------
----------------------------------------------m####------------------------------------------------------#######----------------##----------mm----------------------------------------M----BBB---BBB?------
---------------------------------------------m#####----------------------------------------------------------------------------------------mm-m-----------------------------------------------B------------
-------------------------------mm-----------m######-----#####---#####----------------------------------------------------------m----------mm--Vmm---------------------------------------mm-----------------
----------------------mmmmmmmmmm-mmmmmmmmmmm############----------------------------------mm-m-------------------------------mm-m---------m---[]-m---????MM----------------------------mm-m-----B----------
---------------------m###########################----------------------------------------mm-m-m-------------------------------?----------m----pP--m-------------K----------------------m---mmm-------------
--------------------m###---------------------------------------mm----------------------m-m-##--m----------------------------m----mmmmmmmm#----pP---m----------------------------------m-------m------------
-------------------m###---------------------------------mm----mm-m--------------------mmm--##---m-----mm-------------------m#B---##########---pP----mmmmmmmmmmmmmmmmmmmmmmmmmmmmmmmmmmm--------m-----------
------------------m####-----------------------------m---m-m---m---m-------------------m-#--##----m---mm-mmm--m------------m##----------------###########################################--------mmmmmmmmmmm
-----------------m#####---------------------------mm-m-----m-------m--m--------m----mm--#--##-----m--m-----mm-m--m--m----m###-------------------------------------------------------------------###########
--mmmmmmmmmmmmmmm######--------------------------m##--mm----mm------mm-mmmmmmmm-mmmm##--#--##------mm------##--mm-mm-mmmm####------------------------------------------------------------------------------
#######################--------------------------###---#-----#-------#--#-#-#-#--#-#-#--#--##-------#-----###B--#--#--#######------------------------------------------------------------------------------
