------------------------------------------------------------------------------------------------------------------------------------------------------------------#################################------pP
---------------------------------------------------------------------------------------------------------------------------------------------------------------------------------------------------------pP
---------------------------------------------------------------------------------------------------------------------------------------------------------------------------------------------------------##
-----------------------------------------------------------------------------------------------------------------------------------------------------------------------------------------------------#-----
----------------------------------------M------------------------------------------------------------------------------------------------------------------------------------------------------------------
-----------------------------------------BB-----------------------------------------------------------------------------------------------------------------------------------m----------------------------
----------------------------------------------------------------------------------------------------------------------------------------------------------------B------------m-m---------------------------
----------------------------------------------------------------------------------------------------------------------------------------------------------------------------m#--m--------------------------
----------------------------------------------------------------------------------------------------C-----------mm---------------------------------------------------------m##---m-----------------------mm
--------------------------mm-------------mm-------------mm--??????--------mm--??????---mm----BBBBBBB#----------mm-mmm-------------------------------mm----BBB---mm--------m###----m---------------------mmm
------------------mmm----mC-m-----------mC-m---mmm-----mC-m---------mmm--mC-m---------mC-m-----------mmm---K--mm-----mm---mmmm----------mmm--------mC-m--------mm-m------m####-----m--------------------m--
------------------mC-m---mc--m----------mc--m--mC-m-K--mc--m--------mC-m-mc--m--------mc--m----------mC-m------C-----C-m--m[]-m--mm-----mC-m----K--mc--m------mm---m----m#####------m-------m--mmmmmm--m--V
--mmmmmmmmmmmmmmmm-c--mmmmc---mmmmmmmmmmmC---mm-c--mmmmmC---mmmmmmmm-c--mmc---mmmmmmmmmC---mmmmmmmmmm-c--mmmmmmc-----c--mm-pP--mmh-mmmmm-c--mmmmmmmmc---mmmmmmm-----mmmm######-------mmmmmmm-mm#####-mm#--[
##################################################################################################################--##########################################-------#-#######-------#-#-#-#--######--#---p
