---------------------------------------###############-#-##############---?--------------------------------------------------------------------------------------------------------------------------------
----------------------------------------##############--###############------------------------------------------------------------------------------------------------------------------------------------
-------------------------------------------------------#------------------#-------------------------------mmm-----------------------mmmmmmmmm-------------------------mm-----------------------------------
---------------------------------------------------------------------------------------------------------mm[]mm--??????BBBBBBBB----mm#BBBBBB-m--K--------------------mm-mmm--------------------------------
----------------------------------------------------------------------------------------------mmm-------mm-pP--m-------------------m-#--------m--------K--K------K---m-----m-------------------------------
-----------------------------------------------------------------------------------------------#-m------m--pP---m------------------m-#---------m-------K------K--K--mC------m---------------mmm------------
---------------------------------------------------------------------------------------------mm#--mmmmmm---pP----mmmmmmmmmmmmmmmmmm--#----------mmmmmmmmmmmmmmmmmmmmmc-------m-------------m[]-m-----mmm---
-----------------------------------------B---------------------------------------------------m##########################################################################---#--m------K-----mpP--m----mC-m--
------------------------------------mmm-o---------------------------------------------------m----------------------------------------------------------------------------------mmmmmmmmmmmmmpP---mmmm-c--mm
-----------------------------------m##-m---------------------------------------------------m#---------------------------------------------------------------------------------#############################
----------------------------------m###--m-------------------mmmmmmmmmmmmmo---mmm---m---m--m##--------------------------------------------------------------------------------------------------------------
---------------------------------m####---m-----------------m############-m---m#-mmm-mmm-mm#-#-k------------------------------------------------------------------------------------------------------------
--mmmmmmmmmmmmmmmmmmmmmmmmmmmmmmm#####----mmmmmmmmmmmmmmmmm#############--mmm----######-#######------------------------------------------------------------------------------------------------------------
######################################----#############-################---##--------------------------------------?BBBBBBBBBB*B--------BBBBBBBBBB---------------------------------------------------------
